Here is an introductory paragraph.  Make it clear that we're in rural Wyoming in 1868... just one year before the first transcontinental railway was completed, and one year after the invention of dynamite.  Dynamite is a new thing.  Player is an anti-hero, attempting to rob a train. 

Robber
An IntroComp 2007 game entry by Ben Collins-Sussman and David Anderson
Release 1 / Serial number 070725 / Inform 7 build 4U67 (I6/v6.31 lib 6/11N) SD

Bluff
You're standing on a wide bluff fitfy feet up a small mountain, overlooking a landscape of sun-blasted plains and craggy hills.  Below you, a train track runs out of a narrow tunnel though the hill.  Multiple paths lead further up the mountain.

>down
You'd surely fall to your death.

>up
Bluff
You're standing on a wide bluff halfway up a small mountain, overlooking a landscape of sun-blasted plains and craggy hills.  Below you, a train track runs out of a narrow tunnel though the hill, and then extends off into the distance and around a bend.  Multiple paths lead further up the mountain.

* * *

>down
You'd surely fall to your death.

>x track
You can't see any such thing.

>x train track
You can't see any such thing.

* * *

>x track
The train track extends off into the distance, then curves out of sight around a bend.

>l
Bluff
You're standing on a wide bluff halfway up a small mountain, overlooking a landscape of sun-blasted plains and craggy hills.  Below you, a train track runs out of a narrow tunnel though the hill, and then extends off into the distance and around a bend.  Multiple paths lead further up the mountain.

>z
Time passes.

*** Run-time problem P1: Tried to move the Train (a backdrop) to Approaching Track, which is not a region.

>quit
Are you sure you want to quit?

* * *

>x track
The train track extends off into the distance, then curves out of sight around a bend.

>down
You'd surely fall to your death.

>time
Your pocketwatch reads 10:29 am.

>z
Time passes.

>time
Your pocketwatch reads 10:32 am.

>z
Time passes.

>z
Time passes.

The train is entering the tunnel.

* * *

>down
You'd surely fall to your death.

>z
Time passes.

>time
Your pocketwatch reads 10:30 am.

You hear the train approaching!

>x track
The train track extends off into the distance, then curves around a bend.

You hear the train approaching!

>time
Your pocketwatch reads 10:32 am.

You hear the train approaching!

>z
Time passes.

You hear the train approaching!

>z
Time passes.

A distant wind blows, echoing over the valley.

You hear the train approaching!

The train is entering the tunnel.

>x train
You can't see any such thing.

>down
You'd surely fall to your death.

You hear the train approaching!

The train disappears into the tunnel below you, echoing loudly, leaving behind a wisp of steam.

* * *

>x track
The train track extends off into the distance, then curves out of sight around a bend.

>x train
You can't see any such thing.

>time
Your pocketwatch reads 10:28 am.

* * *

>shoot hat with gun; x gun
You can't see any such thing.

>shoot hat with gun
BANG!  You shoot the hat with the pistol.

>shoot hat with gun
BANG!  You shoot the hat with the pistol.

>shoot hat with gun
BANG!  You shoot the hat with the pistol.

A train appears in the distance, bellowing steam!

>shoot hat with gun
BANG!  You shoot the hat with the pistol.

There's a train moving down the track, getting closer.

>x gun
It's a mean-looking pistol.

It appears to be unloaded.

There's a train moving down the track, getting closer.

>shoot hat with watch
The pocketwatch isn't much of a firearm.

There's a train moving down the track, getting closer.

* * *

>time
Your pocketwatch reads 10:27 am.

>z
Time passes.

A distant wind blows, echoing over the valley.

* * *

>z
Time passes.

>z
Time passes.

You hear the train approaching!

>time
Your pocketwatch reads 10:31 am.

You hear the train approaching!

>time
Your pocketwatch reads 10:32 am.

You hear the train approaching!

>time
Your pocketwatch reads 10:33 am.

You hear the train approaching!

>x train
You can't see any such thing.

>time
Your pocketwatch reads 10:34 am.

You hear the train approaching!

The train is entering the tunnel.

>z
Time passes.

You hear the train approaching!

The train disappears into the tunnel below you, echoing loudly, leaving behind a wisp of steam.

>z
Time passes.

* * *

>x
What do you want to examine?

>i
You are carrying:
  a hat (being worn)
  a pocketwatch

>z
Time passes.

>z
Time passes.

A train appears in the distance, bellowing steam!

>z
Time passes.

There's a train, moving down the track, getting closer.

>z
Time passes.

There's a train, moving down the track, getting closer.

>z
Time passes.

There's a train, moving down the track, getting closer.

The train is now entering the tunnel.

>x
What do you want to examine?

>x train
It's a hulking, steam-driven locomotive, pulling at least ten cars behind it.  

There's a train, moving down the track, getting closer.

* * *

>i
You are carrying:
  a hat (being worn)
  a pocketwatch
  a pistol

>shoot hat
What do you want to shoot the hat with?

>shoot hat with pistol
BANG!  You shoot the hat with the pistol.

>x gun
It's a mean-looking pistol.

It appears to contain three bullets.

A train appears in the distance, bellowing steam!

>shoot train with pistol
BANG!  You shoot the Train with the pistol.

There's a train moving down the track, getting closer.

>x train
It's a hulking, steam-driven locomotive, pulling at least ten cars behind it.   You can see it chugging along, getting closer by the second.

There's a train moving down the track, getting closer.

>x gun
It's a mean-looking pistol.

It appears to contain two bullets.

There's a train moving down the track, getting closer.

>shoot hat with gun
BANG!  You shoot the hat with the pistol.

There's a train moving down the track, getting closer.

>shoot hat with gun
BANG!  You shoot the hat with the pistol.

There's a train moving down the track, getting closer.

The train is now entering the tunnel.

>x gun
It's a mean-looking pistol.

There's a train moving down the track, getting closer.

* * *

>z
Time passes.

>time
Your pocketwatch reads 10:28 am.

>i
You are carrying:
  a hat (being worn)
  a pocketwatch

A train appears in the distance, bellowing steam!

>x
What do you want to examine?

>look
Bluff
You're standing on a wide bluff halfway up a small mountain, overlooking a landscape of sun-blasted plains and craggy hills.  Below you, a train track runs out of a narrow tunnel though the hill.  Multiple paths lead further up the mountain.

You see the train approaching.  It's moving slowly towards you, down the track.

>x track
The train track extends off into the distance, then curves out of sight around a bend.

You see the train approaching.  It's moving slowly towards you, down the track.

>time
Your pocketwatch reads 10:32 am.

You see the train approaching.  It's moving slowly towards you, down the track.

>z
Time passes.

You see the train approaching.  It's moving slowly towards you, down the track.

>time
Your pocketwatch reads 10:34 am.

You see the train approaching.  It's moving slowly towards you, down the track.

The train is entering the tunnel.

>x train
It's a hulking, steam-driven locomotive, pulling at least ten cars behind it.  

You see the train approaching.  It's moving slowly towards you, down the track.

>x watch
It's a rusty wind-up timepiece, handed down from your uncle.  It currently reads 10:36 am.

You see the train approaching.  It's moving slowly towards you, down the track.

The train disappears into the tunnel below you, echoing loudly, leaving behind a wisp of steam.

* * *

>z
Time passes.

A train appears in the distance, bellowing steam!

>time
Your pocketwatch reads 10:30 am.

There's a train moving down the track, getting closer.

>x train
It's a hulking, steam-driven locomotive, pulling at least ten cars behind it.   You can see it chugging along, getting closer by the second. 

There's a train moving down the track, getting closer.

>x train
It's a hulking, steam-driven locomotive, pulling at least ten cars behind it.  

There's a train moving down the track, getting closer.

>xtrain
That's not a verb I recognise.

>x train
It's a hulking, steam-driven locomotive, pulling at least ten cars behind it.  

There's a train moving down the track, getting closer.

>x train
It's a hulking, steam-driven locomotive, pulling at least ten cars behind it.   It's now directly under foot, about to enter the tunnel!

There's a train moving down the track, getting closer.

The train is now entering the tunnel.

>x train
It's a hulking, steam-driven locomotive, pulling at least ten cars behind it.   It's now directly under foot, about to enter the tunnel!

There's a train moving down the track, getting closer.

>x train
It's a hulking, steam-driven locomotive, pulling at least ten cars behind it.   It's now directly under foot, about to enter the tunnel!

There's a train moving down the track, getting closer.

The train disappears into the tunnel below you, echoing loudly, leaving behind a wisp of steam.

>x train
You can't see any such thing.

* * *

>z
Time passes.

A train appears in the distance, bellowing steam!

>z
Time passes.

You see the train approaching!  It's moving slowly towards you, down the track.

>time
Your pocketwatch reads 10:31 am.

You see the train approaching!  It's moving slowly towards you, down the track.

>i
You are carrying:
  a hat (being worn)
  a pocketwatch

You see the train approaching!  It's moving slowly towards you, down the track.

>time
Your pocketwatch reads 10:33 am.

You see the train approaching!  It's moving slowly towards you, down the track.

* * *

>z
Time passes.

You see the train approaching!  It's moving slowly towards you, down the track.

>x train
You can't see any such thing.

* * *

>z
Time passes.

A train appears in the distance, bellowing steam!

>x train
It's a hulking, steam-driven locomotive, pulling at least ten cars behind it.   You can see it chugging in the distance, getting closer by the second.

>z
Time passes.

* * *

>time
Your pocketwatch reads 10:32 am.

>time
Your pocketwatch reads 10:33 am.

>time
Your pocketwatch reads 10:34 am.

The train is entering the tunnel.

>x train
It's a hulking, steam-driven locomotive, pulling at least ten cars behind it.  

The train disappears into the tunnel below you, echoing loudly, leaving behind a wisp of steam.

* * *

>x train
You can't see any such thing.

>z
Time passes.

* * *

>time
Your pocketwatch reads 10:28 am.

>time
Your pocketwatch reads 10:29 am.

>time
Your pocketwatch reads 10:30 am.

>x train
It's a hulking, steam-driven locomotive, pulling at least 10 cars behind it.   You can see it chugging in the distance, getting closer by the second.

>z
Time passes.

* * *

>z
Time passes.

The train is entering the tunnel.

>x train
It's a hulking, steam-driven locomotive, pulling at least 10 cars behind it.  

The train disappears into the tunnel below you, echoing loudly, leaving behind a wisp of steam.

>x train
You can't see any such thing.

* * *

>shoot hat
What do you want to shoot the hat with?

>gun
BANG!  You shoot the hat with the pistol.

* * *

>shoot hat
What do you want to shoot the hat with?

>pistol
BANG!  You shoot the hat with the pistol.

>shoot hat
What do you want to shoot the hat with?