BAM!  A mug of ale hits the table, splashing your shoes.  Muddy Charlie slumps back in his chair, eyes you carefully, and starts to chuckle.

"You know your problem?  You don't think big enough."

His expression is familiar.  Last time you saw that look, it was just before you two decided to rustle the mayor's private herd back in 1866.  That didn't work so well.

"What now?" you ask.  "A new idea?"

"Big plans."  He grins widely.  "That new cross-country railroad is almost finished.  It's gonna change everything... bigger trains, more people... and prize cargo."

"A train holdup?  Are you kidding?"

"Relax.  This time we got technology on our side."  He leans close and whispers:  "Made in Sweden... or Germany.  It's big, dangerous, and nobody knows about it yet."

"A new weapon?"

"Dynamic, buddy.  Dynamic Might." 

Trainstopping
A wild west debacle by Ben Collins-Sussman
Release 9 / Serial number 080229 / Inform 7 build 5J39 (I6/v6.31 lib 6/11N) SD
(Type HELP if you're new to interactive fiction.)

Dirt Road
Muddy wasn't particularly clear in his instructions, but you're pretty sure this is the trail he wanted you to follow this morning.  Now that your horse has inexplicably bolted, you can use all the luck you can get.

This is a dusty trail that wanders off to the west for miles, and ends here near the base of an unscalable mountain just to your east.  It's hot out here;  really hot.  The sun blasts down on the back of your neck, but you can smell the cool tang of some pine trees off to the north.  You also spy some inviting lower slopes that way.

>n
You shamble slowly toward the trees.

Copse
At last, some shade!

You're in a section of dense pine forest at the base of a small mountain.  There are cones and needles littered about, and the treetops chatter with birdsong.  The slope continues up the mountain, or back down towards the road.

You can see a pine cone here.

The sun mercilessly bakes the land.

>n
Grassy Plateau
The land opens up into a large green space here, partway up the mountain. The grasses are nearly five feet high, full of life.  

This is a wide field of untamed prairie.  To the east, a mountain rises up towards its summit, while another hill is faintly visible to the west.  You also can make out a faint trail leading northeast through the brush.

A chipmunk scurries about.

The chipmunk turns its gaze dramatically at you;  is that an orchestra playing?  It bolts away, speeding down.

>n
You can't go that way.

You hear some crickets chirp nearby.

The vulture sails off, heading northeast.

>ne
Bluff
You're standing on a wide bluff about fifty feet up a small mountain, overlooking a landscape of sun-blasted plains and craggy hills.  Below you, a train track runs out of a narrow tunnel though the hill.  On the far edge of the bluff you see a strange rock formation, and a path wanders southwest through the brush.  

A vulture circles omniously overhead.

>look at tunnel
The tunnel runs straight through the mountain, directly below the bluff.  It looks a bit unstable as well, with bits of dirt crumbling into it.  You see a long stick hanging out of the top of the tunnel's arch, probably some remnant of a broken branch.

>take stick
You carefully reach over the edge of the bluff and pluck the stick from the tunnel's arch.

* * *

>n
Grassy Plateau
The land opens up into a large green space here, partway up the mountain. The grasses are nearly five feet high, full of life.  

This is a wide field of untamed prairie.  To the east, a mountain rises up towards its summit, while another hill is faintly visible to the west.  You also can make out a faint trail leading northeast through the brush.

A chipmunk scurries about.

The chipmunk turns its gaze dramatically at you;  is that an orchestra playing?  It bolts away, speeding down.

>e
Summit
You wander east, and slowly climb up the mountain.

Here at the top the mountain, the wind blows strong and carries the smell of endless summer.  There are no trees up here, no tall grass, but bits of shrubbery dot the area.  The view is remarkable, though;  you can see grassy hills for miles around.  A train track clearly extends north into the distance, running away from this mountain.

A chipmunk scurries about.

The chipmunk turns its gaze dramatically at you;  is that an orchestra playing?  It bolts away, speeding west.

>look down
You can't see any such thing.

>x shubbery
You can't see any such thing.

>x shrubbery
It's an ordinary shrub.  Or... wait, is that a piece of string tied to its base?

>x string
The string is tied to the base of the shrub, and seems to run along the ground behind the shrub.   It then dips down out of sight off a cliff at the eastern part the summit.

>take string
As you untie the string from the shrub, you feel a gentle snap on the other end.  The string then slips from your grip and slides off the cliff.

>look at cliff
It's a stark drop at the eastern edge of the summit.  Looking over the cliff, you see a small wooden box sitting on an outcropping about five feet below.

>take box
You lean over the cliff, but the box is at least a couple of feet out of reach.  Maybe if you had some way of grabbing it by its looped handle?

>w
Grassy Plateau
This is a wide field of untamed prairie.  To the east, a mountain rises up towards its summit, while another hill is faintly visible to the west.  You also can make out a faint trail leading northeast through the brush.

A vulture circles omniously overhead.

A chipmunk scurries about.

A distant wind blows, echoing over the hills.

The chipmunk turns its gaze dramatically at you;  is that an orchestra playing?  It bolts away, speeding east.

The vulture sails off, heading west.

>ne
Bluff
You're standing on a wide bluff about fifty feet up a small mountain, overlooking a landscape of sun-blasted plains and craggy hills.  Below you, a train track runs out of a narrow tunnel though the hill.  On the far edge of the bluff you see a strange rock formation, and a path wanders southwest through the brush.

>x tunnel
The tunnel runs straight through the mountain, directly below the bluff.  It looks a bit unstable as well, with bits of dirt crumbling into it.  You see a long stick hanging out of the top of the tunnel's arch, probably some remnant of a broken branch.

>take stick
You carefully reach over the edge of the bluff and pluck the stick from the tunnel's arch.

The sun mercilessly bakes the land.

[Your score has just gone up by one point.]

>sw
Grassy Plateau
This is a wide field of untamed prairie.  To the east, a mountain rises up towards its summit, while another hill is faintly visible to the west.  You also can make out a faint trail leading northeast through the brush.

>e
Summit
Here at the top the mountain, the wind blows strong and carries the smell of endless summer.  There are no trees up here, no tall grass, but bits of shrubbery dot the area.  The view is remarkable, though;  you can see grassy hills for miles around.  A train track clearly extends north into the distance, running away from this mountain.

A chipmunk scurries about.

The chipmunk looks at your possessions and freezes in place for a moment.  It bolts away, speeding west.

>x cliff
It's a stark drop at the eastern edge of the summit.  Looking over the cliff, you see a small wooden box sitting on an outcropping about five feet below.

>x box
It's a small wooden box, with the words "Warning:  Handle Carefully" stamped on it.  It seems to have a looped handle on top.

>take box
Taken.

* * *

>n
Grassy Plateau
The land opens up into a large green space here, partway up the mountain. The grasses are nearly five feet high, full of life.  

This is a wide field of untamed prairie.  To the east, a mountain rises up towards its summit, while another hill is faintly visible to the west.  You also can make out a faint trail leading northeast through the brush.

A chipmunk scurries about.

The chipmunk turns its gaze dramatically at you;  is that an orchestra playing?  It bolts away, speeding down.

>w
Chasm
You press through the grasses, squinting at the bright sky, then suddenly lose your footing.  You scramble to regain your balance and realize you nearly walked off a cliff.

The edge of the plateau stops abruptly at a chasm that drops nearly one hundred feet.  Luckily, there's a flimsy-looking rope bridge that spans the gap.  It stretches westward to another isolated bluff.  To the east, the grasses look more inviting.

>close eyes
It is now pitch dark in here!

>w
Darkness
It is pitch dark, and you can't see a thing.

>w
The sun mercilessly bakes the land.

[Your score has just gone up by one point.]

>x branch
You can't see any such thing.

>open eyes
Lone Tree Bluff
This is a very small bluff, almost an island in a sea of open air.  A gigantic oak tree dominates the space; it's an eruption of countless branches and thick bushy leaves.

Looks like someone left a rusty old bucket here.

>x branch
You see a particularly long branch, fairly high-up.  You see an acorn up there.

The smell of hyacinth wafts in the air.

>shoot branch
BANG!  You fire a bullet at the branch with the revolver. 
Yikes, the branch is a small target.  Your bullet sails right past it.  I guess you could always try again.

>shoot branch
BANG!  You fire a bullet at the branch with the revolver. 
Yikes, the branch is a small target.  Your bullet sails right past it.  I guess you could always try again.

>shoot branch
BANG!  You fire a bullet at the branch with the revolver. 
What luck!  You hit a tiny part of the branch, and the acorn tumbles to the ground.

>x gun
It's a mean-looking revolver, good for... persuasion.

It appears to contain three bullets.

>take acorn
Taken.

>e
You grab hold of the bridge, but your vertigo gets the best of you.  You're unable to avoid looking down, and you feel yourself start to spin.  The sight is just too much.

>close eyes
It is now pitch dark in here!

>e
Darkness
It is pitch dark, and you can't see a thing.

>e
Darkness
It is pitch dark, and you can't see a thing.

A brief breeze flaps your clothing.

>open eyes
Chasm
The edge of the plateau stops abruptly at a chasm that drops nearly one hundred feet.  Luckily, there's a flimsy-looking rope bridge that spans the gap.  It stretches westward to another isolated bluff.  To the east, the grasses look more inviting.

A chipmunk scurries about.

A vulture circles omniously overhead.

>e
Grassy Plateau
This is a wide field of untamed prairie.  To the east, a mountain rises up towards its summit, while another hill is faintly visible to the west.  You also can make out a faint trail leading northeast through the brush.

High above, a vulture glides into the area.

The chipmunk arrives from the west.

>ne
Bluff
You're standing on a wide bluff about fifty feet up a small mountain, overlooking a landscape of sun-blasted plains and craggy hills.  Below you, a train track runs out of a narrow tunnel though the hill.  On the far edge of the bluff you see a strange rock formation, and a path wanders southwest through the brush.  

High above, a vulture glides into the area.

The chipmunk arrives from the southwest.

>x tunnel
The tunnel runs straight through the mountain, directly below the bluff.  It looks a bit unstable as well, with bits of dirt crumbling into it.  You see a long stick hanging out of the top of the tunnel's arch, probably some remnant of a broken branch.

The chipmunk seems paralyzed in place, caught between fear and desire.

>takes stick
That's not a verb I recognise.

>take stick
You carefully reach over the edge of the bluff and pluck the stick from the tunnel's arch.

The chipmunk seems paralyzed in place, caught between fear and desire.

>sw
Grassy Plateau
This is a wide field of untamed prairie.  To the east, a mountain rises up towards its summit, while another hill is faintly visible to the west.  You also can make out a faint trail leading northeast through the brush.

The chipmunk arrives from the northeast.

>e
Summit
You wander east, and slowly climb up the mountain.

Here at the top the mountain, the wind blows strong and carries the smell of endless summer.  There are no trees up here, no tall grass, but bits of shrubbery dot the area.  The view is remarkable, though;  you can see grassy hills for miles around.  A train track clearly extends north into the distance, and a small bluff is visible further down the north face.

The chipmunk arrives from the west.

>x cliff
It's a stark drop at the eastern edge of the summit.  Looking over the cliff, you see a small wooden box sitting on an outcropping about five feet below.  

A brief breeze flaps your clothing.

The chipmunk seems paralyzed in place, caught between fear and desire.

>take box
You lean down off the cliff and delicately balance the edge of the box on your stick, carefully bringing it up to you.

Taken.

The chipmunk seems paralyzed in place, caught between fear and desire.

>open box
You open the box, revealing a stick bundle and a sparker tool.

The chipmunk seems paralyzed in place, caught between fear and desire.

>take all
chipmunk: Ain't no way you're gonna outrun that varmint!
stick bundle: Taken.
sparker tool: Taken.

The chipmunk seems paralyzed in place, caught between fear and desire.

>i
You are carrying:
  a sparker tool
  a stick bundle (empty)
  a box (open but empty)
  a long stick
  an acorn
  a wide-brimmed hat
  a pocketwatch
  a scrap of paper
  your trusty revolver

The chipmunk seems paralyzed in place, caught between fear and desire.

High above, a vulture glides into the area.

>put acorn on tool
You lack the dexterity.

The chipmunk seems paralyzed in place, caught between fear and desire.

>put tool in bundle
You put the sparker tool into the stick bundle.

The chipmunk seems paralyzed in place, caught between fear and desire.

>put acorn on tool
That would be hard to balance.  Try dropping the bundle first.

The chipmunk seems paralyzed in place, caught between fear and desire.

>drop bundle
Dropped.

The chipmunk seems paralyzed in place, caught between fear and desire.

>put acorn on tool
You put the acorn on the sparker tool.

The chipmunk seems paralyzed in place, caught between fear and desire.

>put gun in hat
You put the revolver into the hat.

The vulture sails off, heading west.

>z
Time passes.

>z
Time passes.

The chipmunk enthusiastically jumps up onto the sparker to grab the acorn!
A fiery flash and earth-shattering boom rocks you!  The shock wave literally knocks you off your feet, as debris explodes in all directions.
Unfortunately, being unprotected, you were engulfed by the flames.

    *** Ouch ***

Would you like to RESTART, RESTORE a saved game, or QUIT?

* * *

>w
The sun mercilessly bakes the land.

[Your score has just gone up by one point.]

>open eyes
Lone Tree Bluff
This is a very small bluff, almost an island in a sea of open air.  A gigantic oak tree dominates the space; it's an eruption of countless branches and thick bushy leaves.

Looks like someone left a rusty old bucket here.

>x branch
You see a particularly long branch, fairly high-up.  You see an acorn up there.

>shoot acorn
You hesitate instead, not really wanting to destroy the acorn itself.

>shoot branch
BANG!  You fire a bullet at the branch with the revolver. 
Yikes, the branch is a small target.  Your bullet sails right past it.  I guess you could always try again.

* * *

>shoot branch
BANG!  You fire a bullet at the branch with the revolver. 
What luck!  You hit a tiny part of the branch, and the acorn tumbles to the ground.

>take acorn
Taken.

>x branch
You see a particularly long branch, fairly high-up.

You hear some crickets chirp nearby.

>z
Time passes.

>z
Time passes.

The chipmunk arrives from the east.

>e
You grab hold of the bridge, but your vertigo gets the best of you.  You're unable to avoid looking down, and you feel yourself start to spin.  The sight is just too much.

The chipmunk seems paralyzed in place, caught between fear and desire.

>close eyes
The chipmunk seems paralyzed in place, caught between fear and desire.

It is now pitch dark in here!

>e
Darkness
It is pitch dark, and you can't see a thing.

The sun mercilessly continues to bake the land.

>e
Darkness
It is pitch dark, and you can't see a thing.

>open eyes
Chasm
The edge of the plateau stops abruptly at a chasm that drops nearly one hundred feet.  Luckily, there's a flimsy-looking rope bridge that spans the gap.  It stretches westward to another isolated bluff.  To the east, the grasses look more inviting.

A chipmunk scurries about.

A vulture circles omniously overhead.

>e
Grassy Plateau
This is a wide field of untamed prairie.  To the east, a mountain rises up towards its summit, while another hill is faintly visible to the west.  You also can make out a faint trail leading northeast through the brush.

The chipmunk arrives from the west.

>nw
You can't go that way.

The chipmunk seems paralyzed in place, caught between fear and desire.

>x tunnel
You can't see any such thing.

>x tunnel
You can't see any such thing.

>l
Grassy Plateau
This is a wide field of untamed prairie.  To the east, a mountain rises up towards its summit, while another hill is faintly visible to the west.  You also can make out a faint trail leading northeast through the brush.

A chipmunk scurries about.

The chipmunk seems paralyzed in place, caught between fear and desire.

>ne
Bluff
You're standing on a wide bluff about fifty feet up a small mountain, overlooking a landscape of sun-blasted plains and craggy hills.  Below you, a train track runs out of a narrow tunnel though the hill.  On the far edge of the bluff you see a strange rock formation, and a path wanders southwest through the brush.  

The chipmunk arrives from the southwest.

>take all
chipmunk: Ain't no way you're gonna outrun that varmint!

The chipmunk seems paralyzed in place, caught between fear and desire.

>x track
The track extends off into the distance, then curves out of sight around a far-off hill. 

The chipmunk seems paralyzed in place, caught between fear and desire.

>x tunnel
The tunnel runs straight through the mountain, directly below the bluff.  It looks a bit unstable as well, with bits of dirt crumbling into it.  You see a long stick hanging out of the top of the tunnel's arch, probably some remnant of a broken branch.

The chipmunk seems paralyzed in place, caught between fear and desire.

>x rocks
The rocks are a few feet high, and are roughly arranged in a circle, almost like an oversized fire-pit.  It's not clear if they fell into this formation, or were pushed.

The chipmunk seems paralyzed in place, caught between fear and desire.

>take stick
You carefully reach over the edge of the bluff and pluck the stick from the tunnel's arch.

The chipmunk seems paralyzed in place, caught between fear and desire.

>sw
Grassy Plateau
This is a wide field of untamed prairie.  To the east, a mountain rises up towards its summit, while another hill is faintly visible to the west.  You also can make out a faint trail leading northeast through the brush.

Some sort of insect buzzes by.

The chipmunk arrives from the northeast.

>e
Summit
You wander east, and slowly climb up the mountain.

Here at the top the mountain, the wind blows strong and carries the smell of endless summer.  There are no trees up here, no tall grass, but bits of shrubbery dot the area.  The view is remarkable, though;  you can see grassy hills for miles around.  A train track clearly extends north into the distance, and a small bluff is visible further down the north face.

The chipmunk arrives from the west.

>x bush
It's an ordinary shrub.  Or... wait, is that a piece of string tied to its base?

The chipmunk seems paralyzed in place, caught between fear and desire.

>take string
As you untie the string from the shrub, you feel a gentle snap on the other end.  The string then slips from your grip and slides off the cliff.

The chipmunk seems paralyzed in place, caught between fear and desire.

>look at cliff
It's a stark drop at the eastern edge of the summit.  Looking over the cliff, you see a small wooden box sitting on an outcropping about five feet below.  

The chipmunk seems paralyzed in place, caught between fear and desire.

>take box
You lean down off the cliff and delicately balance the edge of the box on your stick, carefully bringing it up to you.

Taken.

The chipmunk seems paralyzed in place, caught between fear and desire.

* * *

>take all
chipmunk: Ain't no way you're gonna outrun that varmint!
stick bundle: Taken.
sparker tool: Taken.

The chipmunk seems paralyzed in place, caught between fear and desire.

>x sparker
This thing seems familiar;  it looks like a spring-loaded pair of scissors with a small plate at one end.  If you apply a pound or two of pressure to the plate, the device slowly clamps together into a long stick.  When you push the plate quickly, rapid friction on the opposite tip can produce sparks.  It's good for starting campfires or lighting stoves.

You suppose putting stuff on top of the sparker can make it spark too, provided it's heavy enough.  Hm...

The chipmunk seems paralyzed in place, caught between fear and desire.

>put sparker in bundle
You put the sparker tool into the stick bundle.

The chipmunk seems paralyzed in place, caught between fear and desire.

>x bundle
You've never seen anything like this before.  It looks like a collection of cylinders, each wrapped in plain brown paper.  The side of each stick reads "Nobel's Blasting Powder, U.S. Patent 78317."   You don't see any sort of obvious fuse coming out of the sticks, however... just an empty space at the top of each cylinder, big enough to put your finger into.

It currently contains a sparker tool.

The chipmunk seems paralyzed in place, caught between fear and desire.

>w
Grassy Plateau
This is a wide field of untamed prairie.  To the east, a mountain rises up towards its summit, while another hill is faintly visible to the west.  You also can make out a faint trail leading northeast through the brush.

A vulture circles omniously overhead.

The vulture sails off, heading down.

The chipmunk arrives from the east.

>ne
Bluff
You're standing on a wide bluff about fifty feet up a small mountain, overlooking a landscape of sun-blasted plains and craggy hills.  Below you, a train track runs out of a narrow tunnel though the hill.  On the far edge of the bluff you see a strange rock formation, and a path wanders southwest through the brush.  

The chipmunk arrives from the southwest.

>drop bundle
Dropped.

The chipmunk seems paralyzed in place, caught between fear and desire.

>i
You are carrying:
  a box (open but empty)
  a long stick
  an acorn
  a wide-brimmed hat
  a pocketwatch
  a scrap of paper
  your trusty revolver

The chipmunk seems paralyzed in place, caught between fear and desire.

>l
Bluff
You're standing on a wide bluff about fifty feet up a small mountain, overlooking a landscape of sun-blasted plains and craggy hills.  Below you, a train track runs out of a narrow tunnel though the hill.  On the far edge of the bluff you see a strange rock formation, and a path wanders southwest through the brush.  

A chipmunk scurries about.

You can also see a stick bundle (in which is a sparker tool) here.

The chipmunk seems paralyzed in place, caught between fear and desire.

>put acorn on sparker
That would be hard to balance.  Try dropping the sparker tool first.

You put the acorn on the sparker tool.

The chipmunk seems paralyzed in place, caught between fear and desire.

>sw
Grassy Plateau
This is a wide field of untamed prairie.  To the east, a mountain rises up towards its summit, while another hill is faintly visible to the west.  You also can make out a faint trail leading northeast through the brush.

High above, a vulture glides into the area.

>z
Time passes.

A distant wind blows, echoing over the hills.

The vulture sails off, heading west.

>z
Time passes.

You hear a tremendous explosion nearby, and the mountain shakes!

>ne
Bluff
You're standing on the edge of a dangerous, collapsed bluff overlooking a landscape of sun-blasted plains and craggy hills.  Below you, a train track runs out of a narrow tunnel though the hill. (Of course, the tunnel is now completely full of rocks and dirt.)  On the far edge of the bluff you see a strange rock formation, and a path wanders southwest through the brush.

>l
Bluff
You're standing on the edge of a dangerous, collapsed bluff overlooking a landscape of sun-blasted plains and craggy hills.  Below you, a train track runs out of a narrow tunnel though the hill. (Of course, the tunnel is now completely full of rocks and dirt.)  On the far edge of the bluff you see a strange rock formation, and a path wanders southwest through the brush.

>time
Your pocketwatch reads 9:06 am.

A bird chirps somewhere near.

>give hat to bird
Eh?  Either the recipient isn't here, or the recipient isn't something animate.

* * *

>shoot acorn
You hesitate instead, not really wanting to destroy the acorn itself.

>shoot acorn
BANG!  You fire a bullet at the acorn with the revolver. 
Yikes, that's a small target.  Your bullet sails right past it.  I guess you could always try again.

>shoot acorn
BANG!  You fire a bullet at the acorn with the revolver. 
Yikes, that's a small target.  Your bullet sails right past it.  I guess you could always try again.

A brief breeze flaps your clothing.

>shoot acorn
BANG!  You fire a bullet at the acorn with the revolver. 
What luck!  You hit a tiny branch, and the acorn tumbles to the ground.

>take acorn
Taken.

>close eyes
It is now pitch dark in here!

* * *

>e
Darkness
It is pitch dark, and you can't see a thing.

>e
Darkness
It is pitch dark, and you can't see a thing.

>open eyes
Chasm
The edge of the plateau stops abruptly at a chasm that drops nearly one hundred feet.  Luckily, there's a flimsy-looking rope bridge that spans the gap.  It stretches westward to another isolated bluff.  To the east, the grasses look more inviting.

A chipmunk scurries about.

>e
Grassy Plateau
This is a wide field of untamed prairie.  To the east, a mountain rises up towards its summit, while another hill is faintly visible to the west.  You also can make out a faint trail leading northeast through the brush.

The chipmunk arrives from the west.

>ne
Bluff
You're standing on a wide bluff about fifty feet up a small mountain, overlooking a landscape of sun-blasted plains and craggy hills.  Below you, a train track runs out of a narrow tunnel though the hill.  On the far edge of the bluff you see a strange rock formation, and a path wanders southwest through the brush.  

The chipmunk arrives from the southwest.

>x tunnel
The tunnel runs straight through the mountain, directly below the bluff.  It looks a bit unstable as well, with bits of dirt crumbling into it.  You see a long stick hanging out of the top of the tunnel's arch, probably some remnant of a broken branch.

The chipmunk seems paralyzed in place, caught between fear and desire.

>take stick
You carefully reach over the edge of the bluff and pluck the stick from the tunnel's arch.

The chipmunk seems paralyzed in place, caught between fear and desire.

* * *

>sw
Grassy Plateau
This is a wide field of untamed prairie.  To the east, a mountain rises up towards its summit, while another hill is faintly visible to the west.  You also can make out a faint trail leading northeast through the brush.

The chipmunk arrives from the northeast.

>e
Summit
You wander east, and slowly climb up the mountain.

Here at the top the mountain, the wind blows strong and carries the smell of endless summer.  There are no trees up here, no tall grass, but bits of shrubbery dot the area.  The view is remarkable, though;  you can see grassy hills for miles around.  A train track clearly extends north into the distance, and a small bluff is visible further down the north face.

The sun mercilessly continues to bake the land.

The chipmunk arrives from the west.

>x shrub
It's an ordinary shrub.  Or... wait, is that a piece of string tied to its base?

The chipmunk seems paralyzed in place, caught between fear and desire.

>take string
As you untie the string from the shrub, you feel a gentle snap on the other end.  The string then slips from your grip and slides off the cliff.

The chipmunk seems paralyzed in place, caught between fear and desire.

>x cliff
It's a stark drop at the eastern edge of the summit.  Looking over the cliff, you see a small wooden box sitting on an outcropping about five feet below.  

The chipmunk seems paralyzed in place, caught between fear and desire.

>take box
You lean down off the cliff and delicately balance the edge of the box on your stick, carefully bringing it up to you.

Taken.

The chipmunk seems paralyzed in place, caught between fear and desire.

* * *

>open box
You open the box, revealing a stick bundle and a sparker tool.

The chipmunk seems paralyzed in place, caught between fear and desire.

>take bundle and sparker
stick bundle: Taken.
sparker tool: Taken.

A bird chirps somewhere near.

The chipmunk seems paralyzed in place, caught between fear and desire.

>put gun in box
You put the revolver into the box.

The chipmunk seems paralyzed in place, caught between fear and desire.

>close box
You close the box.

The chipmunk looks at your possessions longingly.

>w
Grassy Plateau
This is a wide field of untamed prairie.  To the east, a mountain rises up towards its summit, while another hill is faintly visible to the west.  You also can make out a faint trail leading northeast through the brush.

The chipmunk arrives from the east.

>ne
Bluff
You're standing on a wide bluff about fifty feet up a small mountain, overlooking a landscape of sun-blasted plains and craggy hills.  Below you, a train track runs out of a narrow tunnel though the hill.  On the far edge of the bluff you see a strange rock formation, and a path wanders southwest through the brush.  

The chipmunk arrives from the southwest.

>put sparker in bundle
You put the sparker tool into the stick bundle.

The chipmunk looks at your possessions longingly.

>drop bundle
Dropped.

The chipmunk looks at your possessions longingly.

>put acorn on sparker
That would be hard to balance.  Try dropping the sparker tool first.

You put the acorn on the sparker tool.

>put sparker in bundle
You need to be holding the sparker tool before you can put it into something else.

>enter rocks
You get into the circle of rocks.

The chipmunk enthusiastically jumps up onto the sparker to grab the acorn!
A fiery flash and earth-shattering boom rocks you!  The shock wave literally knocks you off your feet, as debris explodes in all directions.
The chipmunk screams and is torn apart by the exposion.
If that weren't enough, you hear a low rumble, and suddenly the ground begins to crack and crumble.  The earth opens up, and the entire front of the bluff violently collapses downward, filling the tunnel below!

>exit rocks
You get out of the circle of rocks.

Bluff
You're standing on the edge of a dangerous, collapsed bluff overlooking a landscape of sun-blasted plains and craggy hills.  Below you, a train track runs out of a narrow tunnel though the hill. (Of course, the tunnel is now completely full of rocks and dirt.)  On the far edge of the bluff you see a strange rock formation, and a path wanders southwest through the brush.

>time
Your pocketwatch reads 8:54 am.

>wait 70
A distant wind blows, echoing over the hills.

A distant wind blows, echoing over the hills.

A bird chirps somewhere near.

A distant wind blows, echoing over the hills.

A brief breeze flaps your clothing.

A bird chirps somewhere near.

The sun mercilessly continues to bake the land.

The smell of hyacinth wafts in the air.

It is now 10:05 am.

>wait 20
Some sort of insect buzzes by.

A distant wind blows, echoing over the hills.

High above, a vulture glides into the area.

The vulture sails off, heading southwest.

It is now 10:25 am.

>z
Time passes.

>z
Time passes.

>z
Time passes.

A train whistles in the distance!

>z
Time passes.

>x train
You can't see any such thing.

>z
Time passes.

The train is moving down the track, getting closer.

>z
Time passes.

>l
Bluff
You're standing on the edge of a dangerous, collapsed bluff overlooking a landscape of sun-blasted plains and craggy hills.  Below you, a train track runs out of a narrow tunnel though the hill. (Of course, the tunnel is now completely full of rocks and dirt.)  On the far edge of the bluff you see a strange rock formation, and a path wanders southwest through the brush.   

A long train is approaching!

>z
Time passes.

The train is approaching the tunnel!

>z
Time passes.

Seeing the collapsed tunnel, the train engineer yells and slams the brakes!  The giant machine shrieks;  steam and sparks pour from the engine, and the train comes to a stop just inches before the tunnel debris.  You can hear all sorts of panic and screams coming from the train.

In fact, that looks like Muddy himself leaning out of the train window!  He's wildly gesticulating at you.  Is that a a thumbs-up signal he's giving you?

>z
Time passes.

>z
Time passes.

You feel a tap on your back, and you spin around.

Three guns are pointed in your face.

"We know all about your plan", one of Marshalls states coldly.  "We've been tracking you and Muddy for days.  Keep your hands in the air, and follow us."

You can see that Muddy is here, also held at gunpoint and already handcuffed.  You pause for a moment, consider your options, then decide that death is perhaps worse than being locked in a cell with an angry Muddy.

"Don't worry", Muddy whispers.  "I have a plan..."

    *** You have won ***

Would you like to RESTART, RESTORE a saved game, or QUIT?

* * *

>open eyes
Lone Tree Bluff
This is a very small bluff, almost an island in a sea of open air.  A gigantic oak tree dominates the space; it's an eruption of countless branches and thick bushy leaves.

Looks like someone left a rusty old bucket here.

>shoot acorn
You can't see any such thing.

>x branch
You see a particularly long branch, fairly high-up.  You see an acorn up there.

>shoot acorn
BANG!  You fire a bullet at the acorn with the revolver. 
What luck!  You hit a tiny branch, and the acorn tumbles to the ground.

* * *

>take acorn
Taken.

>z
Time passes.

>close eyes
A distant wind blows, echoing over the hills.

It is now pitch dark in here!

>e
Darkness
It is pitch dark, and you can't see a thing.

>open eyes
A distant wind blows, echoing over the hills.

Chasm
The edge of the plateau stops abruptly at a chasm that drops nearly one hundred feet.  Luckily, there's a flimsy-looking rope bridge that spans the gap.  It stretches westward to another isolated bluff.  To the east, the grasses look more inviting.

A chipmunk scurries about.

>show acorn to chipmunk
The chipmunk hops up and down with excitement!

The chipmunk seems paralyzed in place, caught between fear and desire.

>drop acorn
Dropped.

The chipmunk seems paralyzed in place, caught between fear and desire.

>z
Time passes.

The chipmunk seems paralyzed in place, caught between fear and desire.

>z
Time passes.

The chipmunk seems paralyzed in place, caught between fear and desire.

>z
Time passes.

You hear some crickets chirp nearby.

The chipmunk seems paralyzed in place, caught between fear and desire.

>e
Grassy Plateau
This is a wide field of untamed prairie.  To the east, a mountain rises up towards its summit, while another hill is faintly visible to the west.  You also can make out a faint trail leading northeast through the brush.

>z
Time passes.

Some sort of insect buzzes by.

High above, a vulture glides into the area.

>z
Time passes.

>w
Chasm
The edge of the plateau stops abruptly at a chasm that drops nearly one hundred feet.  Luckily, there's a flimsy-looking rope bridge that spans the gap.  It stretches westward to another isolated bluff.  To the east, the grasses look more inviting.

A chipmunk scurries about.

Some sort of insect buzzes by.

The chipmunk seems paralyzed in place, caught between fear and desire.

The chipmunk puts down the acorn.

* * *

>w
Chasm
You press through the grasses, squinting at the bright sky, then suddenly lose your footing.  You scramble to regain your balance and realize you nearly walked off a cliff.

The edge of the plateau stops abruptly at a chasm that drops nearly one hundred feet.  Luckily, there's a flimsy-looking rope bridge that spans the gap.  It stretches westward to another isolated bluff.  To the east, the grasses look more inviting.

>cross bridge
You grab hold of the bridge, but your vertigo gets the best of you.  You're unable to avoid looking down, and you feel yourself start to spin.  The sight is just too much.

>close eyes
It is now pitch dark in here!

* * *

>w
Darkness
It is pitch dark, and you can't see a thing.

>w
Darkness
It is pitch dark, and you can't see a thing.

>open eyes
Lone Tree Bluff
This is a very small bluff, almost an island in a sea of open air.  A gigantic oak tree dominates the space; it's an eruption of countless branches and thick bushy leaves.

Looks like someone left a rusty old bucket here.

>x branches
You see a particularly long branch, fairly high-up.  You see an acorn up there.

>shoot acorn
BANG!  You fire a bullet at the acorn with the revolver. 
You hesitate instead, not really wanting to destroy the acorn itself.

A bird chirps somewhere near.

* * *

>n
Grassy Plateau
The land opens up into a large green space here, partway up the mountain. The grasses are nearly five feet high, full of life.  

This is a wide field of untamed prairie.  To the east, a mountain rises up towards its summit, while another hill is faintly visible to the west.  You also can make out a faint trail leading northeast through the brush.

A chipmunk scurries about.

The chipmunk turns its gaze dramatically at you;  is that an orchestra playing?  It bolts away, speeding down.

>ne
Bluff
You're standing on a wide bluff about fifty feet up a small mountain, overlooking a landscape of sun-blasted plains and craggy hills.  Below you, a train track runs out of a narrow tunnel though the hill.  On the far edge of the bluff you see a strange rock formation, and a path wanders southwest through the brush.

* * *

>x tunnel
The tunnel runs straight through the mountain, directly below the bluff.  It looks a bit unstable as well, with bits of dirt crumbling into it.  You see a long stick hanging out of the top of the tunnel's arch, probably some remnant of a broken branch.

>take stick
You carefully reach over the edge of the bluff and pluck the stick from the tunnel's arch.

[Your score has just gone up by one point.]

>drop stick
Dropped.

>take stick
You carefully reach over the edge of the bluff and pluck the stick from the tunnel's arch.

[Your score has just gone up by one point.]

* * *

>drop stick
Dropped.

>l
Bluff
You're standing on a wide bluff about fifty feet up a small mountain, overlooking a landscape of sun-blasted plains and craggy hills.  Below you, a train track runs out of a narrow tunnel though the hill.  On the far edge of the bluff you see a strange rock formation, and a path wanders southwest through the brush.  

You can see a long stick here.

>take stick
Taken.

* * *

>ne
Bluff
You're standing on a wide bluff about fifty feet up a small mountain, overlooking a landscape of sun-blasted plains and craggy hills.  Below you, a train track runs out of a narrow tunnel though the hill.  On the far edge of the bluff you see a strange rock formation, and a path wanders southwest through the brush.

>x track
The track extends off into the distance, then curves out of sight around a far-off hill.

>x tunnel
The tunnel runs straight through the mountain, directly below the bluff.  It looks a bit unstable as well, with bits of dirt crumbling into it.  You see a long stick hanging out of the top of the tunnel's arch, probably some remnant of a broken branch.

* * *

>take stick
You carefully reach over the edge of the bluff and pluck the stick from the tunnel's arch.

[Your score has just gone up by one point.]

>sw
Grassy Plateau
This is a wide field of untamed prairie.  To the east, a mountain rises up towards its summit, while another hill is faintly visible to the west.  You also can make out a faint trail leading northeast through the brush.

A vulture circles omniously overhead.

The vulture sails off, heading northeast.

>e
Summit
You wander east, and slowly climb up the mountain.

Here at the top the mountain, the wind blows strong and carries the smell of endless summer.  There are no trees up here, no tall grass, but bits of shrubbery dot the area.  The view is remarkable, though;  you can see grassy hills for miles around.  A train track clearly extends north into the distance, running away from this mountain.

>x shrubbery
It's an ordinary shrub.  Or... wait, is that a piece of string tied to its base?

>take string
As you untie the string from the shrub, you feel a gentle snap on the other end.  The string then slips from your grip and slides off the cliff.

>x cliff
It's a stark drop at the eastern edge of the summit.  Looking over the cliff, you see a small wooden box sitting on an outcropping about five feet below.

* * *

>x box
It's a small wooden box, with the words "Warning:  Handle Carefully" stamped on it.  It seems to have a looped handle on top.

>take box
You lean over the cliff and slowly hook the box's looped handle on the end of your stick, carefully bringing it up to you.

Taken.

[Your score has just gone up by one point.]

>open box
You open the box, revealing a stick bundle and a sparker tool.

>take bundle
Taken.

>take tool
Taken.

>put tool in bundle
[Your score has just gone up by one point.]

>shoot bundle
BANG!  You fire a bullet at the stick bundle with the revolver. 
A fiery, actinic flash and earth-shattering boom rocks you!  The shock wave literally knocks you off your feet, as debris explodes in all directions.
Unfortunately, being unprotected, you were engulfed by the flames.

    *** Ouch ***

In that game you scored 3 out of a possible 20, in 18 turns.

Would you like to RESTART, RESTORE a saved game, or QUIT?

* * *

>n
You shamble slowly toward the trees.

Copse
At last, some shade!

You're in a section of dense pine forest at the base of a small mountain.  There are cones and needles littered about, and the treetops chatter with birdsong.  The slope continues up the mountain, or back down towards the road.

You can see a pine cone here.

The sun mercilessly bakes the land.

>ne
You can't go that way.

>e
You can't go that way.

>n
Grassy Plateau
The land opens up into a large green space here, partway up the mountain. The grasses are nearly five feet high, full of life.  

This is a wide field of untamed prairie.  To the east, a mountain rises up towards its summit, while another hill is faintly visible to the west.  You also can make out a faint trail leading northeast through the brush.

A vulture circles omniously overhead.

A chipmunk scurries about.

The chipmunk looks at your possessions and freezes in place for a moment.  It bolts away, speeding west.

>e
Summit
You wander east, and slowly climb up the mountain.

Here at the top the mountain, the wind blows strong and carries the smell of endless summer.  There are no trees up here, no tall grass, but bits of shrubbery dot the area.  The view is remarkable, though;  you can see grassy hills for miles around.  A train track clearly extends north into the distance, running away from this mountain.

* * *

>x shrubbery
It's an ordinary shrub.  Or... wait, is that a piece of string tied to its base?

>x cliff
It's a stark drop at the eastern edge of the summit.  Looking over the cliff, you see a small wooden box sitting on an outcropping about five feet below.  There's a string tied to the box, leading up to a shrub.

A brief breeze flaps your clothing.

>open box
You need to hold the box to do that.

>take bundle
You can't see any such thing.

* * *

>put watch in hat
You put the pocketwatch into the hat.

>put revolver in hat
There is no more room in the hat.

>take watch
You can't see any such thing.

>remove watch from hat
You can't see any such thing.

>take watch from hat
You can't see any such thing.

>i
You are carrying:
  a wide-brimmed hat (being worn)
  a scrap of paper
  your trusty revolver

>eat hat
If you don't complete this mission, you sure will!

>remove hat
You take off the hat.

>take watch out of hat
I only understood you as far as wanting to take the pocketwatch.

* * *

>i
You are carrying:
  a pocketwatch
  a wide-brimmed hat (being carried)
  a scrap of paper
  your trusty revolver

>put revolver in hat
You put the revolver into the hat.

>wear hat
Yeehaw!
The revolver is now concealed from view.

[Your score has just gone up by one point.]

* * *

>who am i?
This game understands commands such as ">examine yourself", but not direct questions. For more instructions, type HELP.

>help
 > Introduction to Trainstopping
   Instructions for Play
   Contacting the author

>
   Introduction to Trainstopping
 > Instructions for Play
   Contacting the author
   Introduction to Trainstopping
 > Instructions for Play
   Contacting the author

>
   Introduction to Trainstopping
   Instructions for Play
 > Contacting the author
   Introduction to Trainstopping
   Instructions for Play
 > Contacting the author

If you have any difficulties with Trainstopping, please contact me at sussman@red-bean.com.

Please press SPACE to continue.

* * *

   Introduction to Trainstopping
   Instructions for Play
 > Contacting the author
   Introduction to Trainstopping
   Instructions for Play
 > Contacting the author

>
   Introduction to Trainstopping
 > Instructions for Play
   Contacting the author
   Introduction to Trainstopping
 > Instructions for Play
   Contacting the author

>
   Introduction to Trainstopping
   Instructions for Play
 > Contacting the author
   Introduction to Trainstopping
   Instructions for Play
 > Contacting the author

>
   Introduction to Trainstopping
 > Instructions for Play
   Contacting the author
   Introduction to Trainstopping
 > Instructions for Play
   Contacting the author

>
 > Introduction to Trainstopping
   Instructions for Play
   Contacting the author
 > Introduction to Trainstopping
   Instructions for Play
   Contacting the author

This is a simple demonstration Western game.

Please press SPACE to continue.

 > Introduction to Trainstopping
   Instructions for Play
   Contacting the author
 > Introduction to Trainstopping
   Instructions for Play
   Contacting the author

This is a simple demonstration Western game.

Please press SPACE to continue.

* * *

 > Introduction to Trainstopping
   Instructions for Play
   Contacting the author
 > Introduction to Trainstopping
   Instructions for Play
   Contacting the author

>þ
 > Introduction to Trainstopping
   Instructions for Play
   Contacting the author

>
   Introduction to Trainstopping
 > Instructions for Play
   Contacting the author
   Introduction to Trainstopping
 > Instructions for Play
   Contacting the author

 > About Interactive Fiction
   What to do with >
   Getting Started
   Rooms and Travel
   Objects
   Controlling the Game
   How the World is Assembled
   If You Get Stuck

The game you are playing is a work of Interactive Fiction.  In interactive fiction you play the main character of a story.  You type commands which determine the actions of the character and the flow of the plot.  Some IF games include graphics, but most do not: the imagery is provided courtesy of your imagination.  On the other hand, there's a wide range of action available: whereas in other games you may be restricted to shooting, movement, or searching items you can click on with a mouse, IF allows you a wide range of verbs.

Please press SPACE to continue.

 > About Interactive Fiction
   What to do with >
   Getting Started
   Rooms and Travel
   Objects
   Controlling the Game
   How the World is Assembled
   If You Get Stuck
 > About Interactive Fiction
   What to do with >
   Getting Started
   Rooms and Travel
   Objects
   Controlling the Game
   How the World is Assembled
   If You Get Stuck

>
   About Interactive Fiction
 > What to do with >
   Getting Started
   Rooms and Travel
   Objects
   Controlling the Game
   How the World is Assembled
   If You Get Stuck
   About Interactive Fiction
 > What to do with >
   Getting Started
   Rooms and Travel
   Objects
   Controlling the Game
   How the World is Assembled
   If You Get Stuck

The > sign is where the game says, "Okay, what do you want to do now?"  You may respond by typing an instruction -- usually an imperative verb, possibly followed by prepositions and objects.  So, for instance, LOOK, LOOK AT FISH, TAKE FISH.

Please press SPACE to continue.

   About Interactive Fiction
 > What to do with >
   Getting Started
   Rooms and Travel
   Objects
   Controlling the Game
   How the World is Assembled
   If You Get Stuck
   About Interactive Fiction
 > What to do with >
   Getting Started
   Rooms and Travel
   Objects
   Controlling the Game
   How the World is Assembled
   If You Get Stuck

>
   About Interactive Fiction
   What to do with >
 > Getting Started
   Rooms and Travel
   Objects
   Controlling the Game
   How the World is Assembled
   If You Get Stuck
   About Interactive Fiction
   What to do with >
 > Getting Started
   Rooms and Travel
   Objects
   Controlling the Game
   How the World is Assembled
   If You Get Stuck

The first thing you want to do when starting a game is acquaint yourself with your surroundings and get a sense of your goal. To this end, you should read the introductory text carefully. Sometimes it contains clues. You will also want to look at the room you are in. Notice where the exits from the room are, and what objects are described here. If any of these seem interesting, you may want to EXAMINE them. 

You might also want to examine yourself (EXAMINE ME) to see whether the author has left you any clues about your character. TAKE INVENTORY will tell you what you're carrying, as well.

Once you've gotten your bearings, you may want to explore. Move from room to room, and check out every location available.

Please press SPACE to continue.

   About Interactive Fiction
   What to do with >
 > Getting Started
   Rooms and Travel
   Objects
   Controlling the Game
   How the World is Assembled
   If You Get Stuck
   About Interactive Fiction
   What to do with >
 > Getting Started
   Rooms and Travel
   Objects
   Controlling the Game
   How the World is Assembled
   If You Get Stuck

>
   About Interactive Fiction
   What to do with >
   Getting Started
 > Rooms and Travel
   Objects
   Controlling the Game
   How the World is Assembled
   If You Get Stuck
   About Interactive Fiction
   What to do with >
   Getting Started
 > Rooms and Travel
   Objects
   Controlling the Game
   How the World is Assembled
   If You Get Stuck

At any given time, you are in a specific location, or room. When you go into a room, the game will print a description of what you can see there. This description will contain two vital kinds of information: things in the room you can interact with or take, and a list of exits, or ways out. If you want to see the description again, you may just type LOOK. 

When you want to leave a location and go to another one, you may communicate this to the game using compass directions: eg, GO NORTH. For simplicity's sake, you are allowed to omit the word GO, and to abbreviate the compass directions. So you may use NORTH, SOUTH, EAST, WEST, NORTHEAST, SOUTHEAST, NORTHWEST, SOUTHWEST, UP, and DOWN, or in short form N, S, E, W, NE, SE, NW, SW, U, and D.

In some locations, IN and OUT will also be useful.

Please press SPACE to continue.

   About Interactive Fiction
   What to do with >
   Getting Started
 > Rooms and Travel
   Objects
   Controlling the Game
   How the World is Assembled
   If You Get Stuck
   About Interactive Fiction
   What to do with >
   Getting Started
 > Rooms and Travel
   Objects
   Controlling the Game
   How the World is Assembled
   If You Get Stuck

>
   About Interactive Fiction
   What to do with >
   Getting Started
   Rooms and Travel
 > Objects
   Controlling the Game
   How the World is Assembled
   If You Get Stuck
   About Interactive Fiction
   What to do with >
   Getting Started
   Rooms and Travel
 > Objects
   Controlling the Game
   How the World is Assembled
   If You Get Stuck

Throughout the game there will be assorted objects that you can do things with. Most importantly, you may TAKE or GET items, and (when you are tired of them) DROP them again. INVENTORY (abbreviated I) will list the items you are currently holding. 

There are usually assorted things you may do with these objects. OPEN, CLOSE, WEAR, EAT, LOCK, and UNLOCK are especially common.

Occasionally, you will find that the game does not recognize the name of an object even though it has been described as being in the room with you. If this is the case, the object is just there for scenery, and you may assume that you do not need to interact with it.

Please press SPACE to continue.

   About Interactive Fiction
   What to do with >
   Getting Started
   Rooms and Travel
 > Objects
   Controlling the Game
   How the World is Assembled
   If You Get Stuck
   About Interactive Fiction
   What to do with >
   Getting Started
   Rooms and Travel
 > Objects
   Controlling the Game
   How the World is Assembled
   If You Get Stuck

Throughout the game there will be assorted objects that you can do things with. Most importantly, you may TAKE or GET items, and (when you are tired of them) DROP them again. INVENTORY (abbreviated I) will list the items you are currently holding. 

There are usually assorted things you may do with these objects. OPEN, CLOSE, WEAR, EAT, LOCK, and UNLOCK are especially common.

Occasionally, you will find that the game does not recognize the name of an object even though it has been described as being in the room with you. If this is the case, the object is just there for scenery, and you may assume that you do not need to interact with it.

Please press SPACE to continue.

* * *

   About Interactive Fiction
   What to do with >
   Getting Started
   Rooms and Travel
 > Objects
   Controlling the Game
   How the World is Assembled
   If You Get Stuck
   About Interactive Fiction
   What to do with >
   Getting Started
   Rooms and Travel
 > Objects
   Controlling the Game
   How the World is Assembled
   If You Get Stuck

>
   About Interactive Fiction
   What to do with >
   Getting Started
   Rooms and Travel
   Objects
 > Controlling the Game
   How the World is Assembled
   If You Get Stuck
   About Interactive Fiction
   What to do with >
   Getting Started
   Rooms and Travel
   Objects
 > Controlling the Game
   How the World is Assembled
   If You Get Stuck

There are a few simple commands for controlling the game itself. These are: 

SAVE saves a snapshot of the game as it is now. 
RESTORE puts the game back to a previous saved state. You may keep as many saved games as you like. 
RESTART puts the game back to the way it was at the beginning. 
QUIT ends the game.

Please press SPACE to continue.

   About Interactive Fiction
   What to do with >
   Getting Started
   Rooms and Travel
   Objects
 > Controlling the Game
   How the World is Assembled
   If You Get Stuck
   About Interactive Fiction
   What to do with >
   Getting Started
   Rooms and Travel
   Objects
 > Controlling the Game
   How the World is Assembled
   If You Get Stuck

>
   About Interactive Fiction
   What to do with >
   Getting Started
   Rooms and Travel
   Objects
   Controlling the Game
 > How the World is Assembled
   If You Get Stuck
   About Interactive Fiction
   What to do with >
   Getting Started
   Rooms and Travel
   Objects
   Controlling the Game
 > How the World is Assembled
   If You Get Stuck

 > Space
   Containment
   Types of Action
   Other Characters

Most IF games are set in a world made up of rooms without internal division. Movement between rooms is possible; movement within a room does not always amount to anything. >WALK OVER TO THE DESK is rarely a useful sort of command. On the other hand, if something is described as being high or out of reach, it is sometimes relevant to stand on an object to increase your height. This kind of activity tends to be important only if prompted by the game text.

Please press SPACE to continue.

 > Space
   Containment
   Types of Action
   Other Characters
 > Space
   Containment
   Types of Action
   Other Characters

>
   Space
 > Containment
   Types of Action
   Other Characters
   Space
 > Containment
   Types of Action
   Other Characters

One thing that IF does tend to model thoroughly is containment. Is something in or on something else? The game keeps track of this, and many puzzles have to do with where things are -- in the player's possession, lying on the floor of the room, on a table, in a box, etc.

Please press SPACE to continue.

   Space
 > Containment
   Types of Action
   Other Characters
   Space
 > Containment
   Types of Action
   Other Characters

>
   Space
   Containment
 > Types of Action
   Other Characters
   Space
   Containment
 > Types of Action
   Other Characters

Most of the actions you can perform in the world of IF are brief and specific. >WALK WEST or >OPEN DOOR are likely to be provided. >TAKE A JOURNEY or >BUILD A TABLE are not. Things like >GO TO THE HOTEL are on the borderline: some games allow them, but most do not. In general, abstract, multi-stage behavior usually has to be broken down in order for the game to understand it. 

Please press SPACE to continue.

   Space
   Containment
 > Types of Action
   Other Characters
   Space
   Containment
 > Types of Action
   Other Characters

>
   Space
   Containment
   Types of Action
 > Other Characters
   Space
   Containment
   Types of Action
 > Other Characters

Other characters in IF games are sometimes rather limited. On the other hand, there are also games in which character interaction is the main point of the game. You should be able to get a feel early on for the characters -- if they seem to respond to a lot of questions, remember what they're told, move around on their own, etc., then they may be fairly important. If they have a lot of stock responses and don't seem to have been the game designer's main concern, then they are most likely present either as local color or to provide the solution to a specific puzzle or set of puzzles. Characters in very puzzle-oriented games often have to be bribed, threatened, or cajoled into doing something that the player cannot do -- giving up a piece of information or an object, reaching something high, allowing the player into a restricted area, and so on.

Please press SPACE to continue.

   Space
   Containment
   Types of Action
 > Other Characters
   Space
   Containment
   Types of Action
 > Other Characters

>q
   About Interactive Fiction
   What to do with >
   Getting Started
   Rooms and Travel
   Objects
   Controlling the Game
 > How the World is Assembled
   If You Get Stuck

>
   About Interactive Fiction
   What to do with >
   Getting Started
   Rooms and Travel
   Objects
   Controlling the Game
   How the World is Assembled
 > If You Get Stuck
   About Interactive Fiction
   What to do with >
   Getting Started
   Rooms and Travel
   Objects
   Controlling the Game
   How the World is Assembled
 > If You Get Stuck

 > Explore
   Read carefully
   Be creative
   Cooperate

>
   Explore
 > Read carefully
   Be creative
   Cooperate
   Explore
 > Read carefully
   Be creative
   Cooperate

>
   Explore
   Read carefully
 > Be creative
   Cooperate
   Explore
   Read carefully
 > Be creative
   Cooperate

>
   Explore
   Read carefully
   Be creative
 > Cooperate
   Explore
   Read carefully
   Be creative
 > Cooperate

>
   Explore
   Read carefully
 > Be creative
   Cooperate
   Explore
   Read carefully
 > Be creative
   Cooperate

Rephrase. If there's something you want to do, but the game doesn't seem to understand you, try alternative wordings. 

Try variations. Sometimes an action doesn't work, but does produce some kind of unusual result. These are often indications that you're on the right track, even if you haven't figured out quite the right approach yet. Pressing the red button alone may only cause a grinding noise from inside the wall, so perhaps pressing the blue and then the red will open the secret door.

Consider the genre of the game. Mysteries, romances, and thrillers all have their own types of action and motivation. What are you trying to do, and how do conventional characters go about doing that? What's the right sort of behavior for a detective/romance heroine/spy?

Please press SPACE to continue.

   Explore
   Read carefully
 > Be creative
   Cooperate
   Explore
   Read carefully
 > Be creative
   Cooperate

>q
   About Interactive Fiction
   What to do with >
   Getting Started
   Rooms and Travel
   Objects
   Controlling the Game
   How the World is Assembled
 > If You Get Stuck

>q
   Introduction to Trainstopping
 > Instructions for Play
   Contacting the author

>þ
   Introduction to Trainstopping
 > Instructions for Play
   Contacting the author

>q
Dirt Road
This is a dusty trail that wanders off to the west for miles, and ends here near the base of an unscalable mountain just to your east.  It's hot out here;  really hot.  The sun blasts down on the back of your neck, but you can smell the cool tang of some pine trees off to the north.  You also spy some inviting lower slopes that way.

* * *

>help
 > Introduction to Trainstopping
   Instructions for Play
   Contacting the Author

>
   Introduction to Trainstopping
 > Instructions for Play
   Contacting the Author
   Introduction to Trainstopping
 > Instructions for Play
   Contacting the Author

>
   Introduction to Trainstopping
   Instructions for Play
 > Contacting the Author
   Introduction to Trainstopping
   Instructions for Play
 > Contacting the Author

This game is far from bug-free!  If you discover any problems or difficulties (or just have suggestions), please contact me at sussman@red-bean.com.

Please press SPACE to continue.

   Introduction to Trainstopping
   Instructions for Play
 > Contacting the Author
   Introduction to Trainstopping
   Instructions for Play
 > Contacting the Author

>
   Introduction to Trainstopping
 > Instructions for Play
   Contacting the Author
   Introduction to Trainstopping
 > Instructions for Play
   Contacting the Author

>q
Dirt Road
This is a dusty trail that wanders off to the west for miles, and ends here near the base of an unscalable mountain just to your east.  It's hot out here;  really hot.  The sun blasts down on the back of your neck, but you can smell the cool tang of some pine trees off to the north.  You also spy some inviting lower slopes that way.

* * *

   Introduction to Trainstopping
   Instructions for Play
 > Contacting the Author
   Introduction to Trainstopping
   Instructions for Play
 > Contacting the Author

>þ
   Introduction to Trainstopping
   Instructions for Play
 > Contacting the author

>q
Dirt Road
This is a dusty trail that wanders off to the west for miles, and ends here near the base of an unscalable mountain just to your east.  It's hot out here;  really hot.  The sun blasts down on the back of your neck, but you can smell the cool tang of some pine trees off to the north.  You also spy some inviting lower slopes that way.

>i
You are carrying:
  a wide-brimmed hat
  a pocketwatch
  a scrap of paper
  your trusty revolver

* * *

>remove hat
You take off the hat.

>put gun in hat
[Your score has just gone up by one point.]

>wear hat
The revolver is now concealed from view.

>n
You shamble slowly toward the trees.

Copse
At last, some shade!

You're in a section of dense pine forest at the base of a small mountain.  There are cones and needles littered about, and the treetops chatter with birdsong.  The slope continues up the mountain, or back down towards the road.

You can see a pine cone here.

>take cone
Taken.

>examine cone
Yep, it's a pine cone.

High above, a vulture glides into the area.

>n
Grassy Plateau
The land opens up into a large green space here, partway up the mountain. The grasses are nearly five feet high, full of life.  

This is a wide field of untamed prairie.  To the east, a mountain rises up towards its summit, while another hill is faintly visible to the west.  You also can make out a faint trail leading northeast through the brush.

A chipmunk scurries about.

The chipmunk sniffs around, mostly ignoring you.

>w
Chasm
You press through the grasses, squinting at the bright sky, then suddenly lose your footing.  You scramble to regain your balance and realize you nearly walked off a cliff.

The edge of the plateau stops abruptly at a chasm that drops nearly one hundred feet.  Luckily, there's a flimsy-looking rope bridge that spans the gap.  It stretches westward to another isolated bluff.  To the east, the grasses look more inviting.

>w
You grab hold of the bridge, but your vertigo gets the best of you.  You're unable to avoid looking down, and you feel yourself start to spin.  The sight is just too much.

A brief breeze flaps your clothing.

>close eyes
It is now pitch dark in here!

* * *

>open eyes
Lone Tree Bluff
This is a very small bluff, almost an island in a sea of open air.  A gigantic oak tree dominates the space; it's an eruption of countless branches and thick bushy leaves.

Looks like someone left a rusty old bucket here.

I beg your pardon?

>shoot branch
You need some sort of firearm to do that.

>take gun
You can't see any such thing.

>remove hat
You take off the hat.

>take gun from hat
Taken.

* * *

>shoot branch
BANG!  You fire a bullet at the branch with the revolver.

>shoot branch
BANG!  You fire a bullet at the branch with the revolver.

>examine branch
You see a particularly long branch, fairly high-up.  You see an acorn up there.

>shoot acorn
You hesitate instead, not really wanting to destroy the acorn itself.

* * *

>shoot branch
BANG!  You fire a bullet at the branch with the revolver. 
Yikes, the branch is a small target.  Your bullet sails right past it.  I guess you could always try again.

>shoot branch
BANG!  You fire a bullet at the branch with the revolver. 
Yikes, the branch is a small target.  Your bullet sails right past it.  I guess you could always try again.

Some sort of insect buzzes by.

>shoot branch
BANG!  You fire a bullet at the branch with the revolver. 
What luck!  You hit a tiny part of the branch, and the acorn tumbles to the ground.

>examine gun
It's a mean-looking revolver.  Somebody tried to take it from you once.  Once.

It appears to be unloaded.

* * *

>x hat
A wide-brimmed hat to protect you from the sun, and which clearly marks you as a denizen of the plains.

>remove hat
You take off the hat.

>put watch in hat
You put the pocketwatch into the hat.

>i
You are carrying:
  a wide-brimmed hat (being carried)
  a scrap of paper
  your trusty revolver

High above, a vulture glides into the area.

>wear hat
Yeehaw!
The pocketwatch is now concealed from view!

>time
You have no way of checking the time.