BAM!  A mug of ale hits the table, splashing your shoes.  Muddy Charlie slumps back in his chair, eyes you carefully, and starts to chuckle.

"You know your problem?  You don't think big enough."

His expression is familiar.  Last time you saw that look, it was just before you two decided to hijack the mayor's private herd back in 1866.  That didn't work so well.

"What now?" you ask.  "A new idea?"

"Big plans."  He grins widely.  "That new cross-country railroad is almost finished.  It's gonna change everything... bigger trains, more people... and prize cargo."

"A train holdup?  Are you kidding?"

"Relax.  This time we got technology on our side."  He leans close and whispers:  "Made in Sweden... or Germany.  It's big, dangerous, and nobody knows about it yet."

"A new weapon?"

"Dynamic, buddy.  Dynamic Might." 

Trainstopping
An IntroComp 2007 game entry by Ben Collins-Sussman
Release 1 / Serial number 070803 / Inform 7 build 4U67 (I6/v6.31 lib 6/11N) SD

Dirt Road
Muddy wasn't particularly clear in his instructions, but you're pretty sure this is the trail he wanted you to follow this morning.  Now that your horse has inexplicably bolted, you can use all the luck you can get.

This is a dusty trail that wanders off east and west for miles.  The sun blasts down on the back of your neck, but you can smell the cool tang of some pine trees off to the north.  You also spy the lower slopes of a small mountain that way.

>x shrub
It's an ordinary shrub.Or... wait, is that a piece of string tied to its base?

>x string
The string is tied to the base of the shrub, and seems to run along the ground behind the shrub.   It then dips down out of sight, off a cliff at the eastern part the summit.

>take string
As you untie the string from the shrub, you feel a gentle snap on the other end.  The string then slips from your grip and slides off the cliff.

>x string
You can't see any such thing.

>l
Summit
Here at the top the mountain, the wind blows strong and carries the smell of endless summer.  There are no trees up here, no tall grass, but bits of shrubbery dot the area.  The view is remarkable, though;  you can see grassy hills for miles around.  A train track clearly extends north into the distance, and a small bluff is visible further down the north face.

A vulture circles omniously overhead.

>x shrub
It's an ordinary shrub.  Or... wait, is that a piece of string tied to its base?

The vulture sails off, heading west.

* * *

>take string
As you untie the string from the shrub, you feel a gentle snap on the other end.  The string then slips from your grip and slides off the cliff.

>take shrub
That's hardly portable.

* * *

>x string
The string is tied to the base of the shrub, and seems to run along the ground behind the shrub.   It then dips down out of sight, off a cliff at the eastern part the summit.

>take shrub
That's hardly portable.

The vulture sails off, heading west.

>take string
Taken.

>follow string
That's not a verb I recognise.

>look south
I only understood you as far as wanting to look.

>look down
I only understood you as far as wanting to look.

>look
Summit
Here at the top the mountain, the wind blows strong and carries the smell of endless summer.  There are no trees up here, no tall grass, but bits of shrubbery dot the area.  The view is remarkable, though;  you can see grassy hills for miles around.  A train track clearly extends north into the distance, and a small bluff is visible further down the north face.

* * *

>x shrub
It's an ordinary shrub.Or... wait, is that a piece of string tied to its base?

>take string
As you untie the string from the shrub, you feel a gentle snap on the other end.  The string then slips from your grip and slides off the cliff.

The vulture sails off, heading west.

>x string
The string is tied to the base of the shrub, and seems to run along the ground behind the shrub.   It then dips down out of sight, off a cliff at the eastern part the summit.

High above, a vulture glides into the area.

* * *

>take string
As you untie the string from the shrub, you feel a gentle snap on the other end.  The string then slips from your grip and slides off the cliff.

The vulture sails off, heading west.

>x shrub
It's an ordinary shrub.

Some sort of insect buzzes by.

>l
Summit
Here at the top the mountain, the wind blows strong and carries the smell of endless summer.  There are no trees up here, no tall grass, but bits of shrubbery dot the area.  The view is remarkable, though;  you can see grassy hills for miles around.  A train track clearly extends north into the distance, and a small bluff is visible further down the north face.

>x cliff
You can't see any such thing.

* * *

>w
Grassy Plateau
The land opens up into a large green space here, partway up the mountain. The grasses are nearly five feet high, full of life.  A nice place to take a napw if you didn't already have better things to do.

This is a wide field of untamed prairie.  To the east, a the mountain rises up towards its summit, while another hill is faintly visible to the west.  You also can make out a faint trail leading northeast through the brush.

A chipmunk scurries about.

The chipmunk spins around, looks at you, then panics.  The chipmunk bolts away, speeding west.

>ne
Bluff
You're standing on a wide bluff about fifty feet up a small mountain, overlooking a landscape of sun-blasted plains and craggy hills.  Below you, a train track runs out of a narrow tunnel though the hill.  On the far edge of the bluff you see a strange rock formation, and a path wanders southwest through the brush.  

A distant wind blows, echoing over the hills.

>take stick
Taken.

>sw
Grassy Plateau
This is a wide field of untamed prairie.  To the east, a the mountain rises up towards its summit, while another hill is faintly visible to the west.  You also can make out a faint trail leading northeast through the brush.

A chipmunk scurries about.

The chipmunk turns its gaze dramatically at you;  is that an orchestra playing?  The chipmunk bolts away, speeding west.

>e
Summit
Here at the top the mountain, the wind blows strong and carries the smell of endless summer.  There are no trees up here, no tall grass, but bits of shrubbery dot the area.  The view is remarkable, though;  you can see grassy hills for miles around.  A train track clearly extends north into the distance, and a small bluff is visible further down the north face.

>take box
You lean down off the cliff and delicately balance the edge of the box on your stick, carefully bringing it up to you.

Taken.

>i
You are carrying:
  a box (closed)
  a long stick
  a hat (being worn)
  a pocketwatch
  a scrap of paper
  your trusty pistol

>open box
You open the box, revealing a stick bundle and a sparker tool.

>i
You are carrying:
  a box (open)
    a stick bundle (empty)
    a sparker tool
  a long stick
  a hat (being worn)
  a pocketwatch
  a scrap of paper
  your trusty pistol

>time
Your pocketwatch reads 9:24 am.

* * *

>ne
Bluff
You're standing on a wide bluff about fifty feet up a small mountain, overlooking a landscape of sun-blasted plains and craggy hills.  Below you, a train track runs out of a narrow tunnel though the hill.  On the far edge of the bluff you see a strange rock formation, and a path wanders southwest through the brush.  

A distant wind blows, echoing over the hills.

>x tunnel
The tunnel runs straight through the mountain, directly below the bluff.  It looks a bit unstable as well, with bits of dirt crumbling into it, and some sort of stick is pushing through.

>take stick
Taken.

>x rock formation
You can't see any such thing.

>x rocks
The rocks are a few feet high, and are roughly arranged in a circle, almost like an oversized fire-pit.  It's not clear if they fell into this formation, or were pushed.

>enter circle
You get into the circle of rocks.

>exit
You get out of the circle of rocks.

Bluff
You're standing on a wide bluff about fifty feet up a small mountain, overlooking a landscape of sun-blasted plains and craggy hills.  Below you, a train track runs out of a narrow tunnel though the hill.  On the far edge of the bluff you see a strange rock formation, and a path wanders southwest through the brush.

* * *

>take box
There's no way you can reach down to the box, it's at least a couple of feet out of reach.

The vulture sails off, heading west.

>open box
You open the box, revealing a stick bundle and a sparker tool.

>x bundle
It looks like a collection of cylinders, each wrapped in plain brown paper.  The side of each stick reads "Nobel's Blasting Powder, U.S. Patent 78317."   You don't see any sort of obvious fuse coming out of the sticks, however... just an empty space at the top of each cylinder, big enough to put your finger into.

It currently contains nothing.

The vulture sails off, heading west.

>x tool
You've seen something like this before;  it looks like a spring-loaded pair of scissors with a small plate at one end.  If you apply a pound or two of pressure to the plate, the device slowly clamps together into a long stick.  When you push the plate quickly, rapid friction on the opposite tip can produce sparks.

>x outcropping
It's a small outcropping sticking out from the wall of the cliff, just hanging in space.

* * *

>take box
There's no way you can reach down to the box, it's at least a couple of feet out of reach.

The vulture sails off, heading west.

>take string
As you untie the string from the shrub, you feel a gentle snap on the other end.  The string then slips from your grip and slides off the cliff.

High above, a vulture glides into the area.

>x cliff
It's a stark drop at the eastern edge of the summit.  Looking over the cliff, you see a small wooden box sitting on an outcropping about five feet below.  

The vulture sails off, heading west.

* * *

>x string
The string is tied to the base of the shrub, and seems to run along the ground behind the shrub.   It then dips down out of sight, off a cliff at the eastern part the summit.

You hear some crickets chirp nearby.

The vulture sails off, heading west.

>take string
You pull on the string and feel a gentle snap;  it was tied to something, apparently.

* * *

>x sky
It's brightly lit, full of saturated blue, not a cloud in sight.

>take sky
That's hardly portable.

* * *

>x cliff
It's a stark drop at the southern edge of the summit.  Looking over the cliff, you see a small wooden box sitting on an outcropping about five feet below.  There's a string tied to the box, leading up to a shrub.

>take string
As you untie the string from the shrub, you feel a gentle snap on the other end.  The string then slips from your grip and slides off the cliff.

The vulture sails off, heading west.

>x cliff
It's a stark drop at the southern edge of the summit.  Looking over the cliff, you see a small wooden box sitting on an outcropping about five feet below.

* * *

>x cliff
It's a stark drop at the southern edge of the summit.  Looking over the cliff, you see a small wooden box sitting on an outcropping about five feet below.  There's a string tied to the box, leading up to a shrub.

>x shrub
It's an ordinary shrub.  Or... wait, is that a piece of string tied to its base?

>take string
As you untie the string from the shrub, you feel a gentle snap on the other end.  The string then slips from your grip and slides off the cliff.

>x cliff
It's a stark drop at the southern edge of the summit.  Looking over the cliff, you see a small wooden box sitting on an outcropping about five feet below.  

The vulture sails off, heading west.

>x box
It's a small wooden box, with the words "Warning:  Handle Carefully" stamped on it.

>take box
Taken.

* * *

>x outcropping
It's a small outcropping sticking out from the wall of the cliff, just hanging in space.

The vulture sails off, heading west.

>x box
It's a small wooden box, with the words "Warning:  Handle Carefully" stamped on it.

>x cliff
It's a stark drop at the eastern edge of the summit.  Looking over the cliff, you see a small wooden box sitting on an outcropping about five feet below.  There's a string tied to the box, leading up to a shrub.

>x shrub
It's an ordinary shrub.  Or... wait, is that a piece of string tied to its base?

>take box
Taken.

>reach
That's not a verb I recognise.

* * *

>push string w
Is that the best you can think of?

>push string
Nothing obvious happens.

>take string
As you untie the string from the shrub, you feel a gentle snap on the other end.  The string then slips from your grip and slides off the cliff.

* * *

>x cliff
It's a stark drop at the eastern edge of the summit.  Looking over the cliff, you see a small wooden box sitting on an outcropping about five feet below.

>restart
Are you sure you want to restart?

* * *

>x box
It's a small wooden box, with the words "Warning:  Handle Carefully" stamped on it.

>take box
Taken.

You hear some crickets chirp nearby.

>look in box
You can't see inside, since the box is closed.

The vulture sails off, heading west.

>open box
That's not something you can open.

* * *

>n
You shamble slowly toward the trees.

Copse
At last, some shade!

You're in a section of dense pine forest at the base of a small mountain.  There are cones and needles littered about, and the treetops chatter with birdsong.  The slope continues up the mountain, or back down towards the road.

You can see a pine cone here.

>up
Grassy Plateau
The land opens up into a large green space here, partway up the mountain. The grasses are nearly five feet high, full of life.  A nice place to take a napw if you didn't already have better things to do.

This is a wide field of untamed prairie.  To the east, a the mountain rises up towards its summit, while another hill is faintly visible to the west.  You also can make out a faint trail leading northeast through the brush.

A chipmunk scurries about.

The chipmunk spins around, looks at you, then panics.  The chipmunk bolts away, speeding northeast.

>w
Chasm
You press through the grasses, squinting at the bright sky, then suddenly lose your footing.  You scramble to regain your balance and realize you nearly walked off a cliff.

The edge of the plateau stops abruptly at a chasm that drops nearly one hundred feet.  Luckily, there's a flimsy-looking rope bridge that spans the gap.  It stretches westward to another isolated bluff.

>close eyes
It is now pitch dark in here!

* * *

>open eyes
Lone Tree Bluff
This is a very small bluff, almost an island in a sea of open air.  A gigantic oak tree dominates the space; it's an eruption of countless branches and thick bushy leaves.

Looks like someone left a rusty old bucket here.

>take bucket
Taken.

>x bucket
It's an old green bucket, well-used.

>throw bucket
Dropped.

>take bucket
Taken.

>put paper in bucket
You put the scrap of paper into the bucket.

The smell of hyacinth wafts in the air.

>i
You are carrying:
  a bucket
    a scrap of paper
  a hat (being worn)
  a pocketwatch
  your trusty pistol

* * *

>put gun in hat
You put the pistol into the hat.

>n
You can't go that way.

The vulture sails off, heading west.

>w
Grassy Plateau
The land opens up into a large green space here, partway up the mountain. The grasses are nearly five feet high, full of life.  A nice place to take a napw if you didn't already have better things to do.

This is a wide field of untamed prairie.  To the east, a the mountain rises up towards its summit, while another hill is faintly visible to the west.  You also can make out a faint trail leading northeast through the brush.

A vulture circles omniously overhead.

A chipmunk scurries about.

The chipmunk sniffs around, mostly ignoring you.

>w
Cliff Edge
You press through the grasses, squinting at the bright sky, then suddenly lose your footing.  You scramble to regain your balance and realize you nearly walked off a cliff.

The edge of the plateau stops abruptly at a chasm that drops nearly one hundred feet.  Luckily, there's a flimsy-looking rope bridge that spans the gap.  It stretches westward to another isolated bluff.

>close eyes
It is now pitch dark in here!

* * *

>w
Darkness
It is pitch dark, and you can't see a thing.

>open eyes
Lone Tree Bluff
This is a very small bluff, almost an island in a sea of open air.  A gigantic oak tree dominates the space; it's an eruption of countless branches and thick bushy leaves.

>shoot acorn
You need some sort of firearm to do that.

>remove hat
You take off the hat.

>take gun
Taken.

A brief breeze flaps your clothing.

>shoot acorn
BANG!  You fire a bullet at the acorn with the pistol. 
What luck!  You hit a tiny branch, and the acorn tumbles to the ground.

>time
Your pocketwatch reads 9:27 am.

>take acorn
Taken.

* * *

>e
You grab hold of the bridge, but your vertigo gets the best of you.  You're unable to avoid looking down, and you feel yourself start to spin.  The sight is just too much.

>close eyes
The chipmunk arrives from the east.

It is now pitch dark in here!

>e
Darkness
It is pitch dark, and you can't see a thing.

>open eyes
You hear some crickets chirp nearby.

Cliff Edge
The edge of the plateau stops abruptly at a chasm that drops nearly one hundred feet.  Luckily, there's a flimsy-looking rope bridge that spans the gap.  It stretches westward to another isolated bluff.

A chipmunk scurries about.

>x chipmunk
A slippery little varmint.  He appears to be searching for something.

The chipmunk seems paralyzed in place, caught between fear and desire!

>i
You are carrying:
  an acorn
  your trusty pistol
  a hat
  a pocketwatch
  a scrap of paper

The chipmunk seems paralyzed in place, caught between fear and desire!

>put gun in hat
You put the pistol into the hat.

The sun mercilessly continues to bake the land.

The chipmunk seems paralyzed in place, caught between fear and desire!

>ne
You can't go that way.

The chipmunk seems paralyzed in place, caught between fear and desire!

>i
You are carrying:
  an acorn
  a hat
    your trusty pistol
  a pocketwatch
  a scrap of paper

The chipmunk seems paralyzed in place, caught between fear and desire!

>l
Cliff Edge
The edge of the plateau stops abruptly at a chasm that drops nearly one hundred feet.  Luckily, there's a flimsy-looking rope bridge that spans the gap.  It stretches westward to another isolated bluff.

A chipmunk scurries about.

The chipmunk seems paralyzed in place, caught between fear and desire!

>e
Grassy Plateau
This is a wide field of untamed prairie.  To the east, a the mountain rises up towards its summit, while another hill is faintly visible to the west.  You also can make out a faint trail leading northeast through the brush.

A vulture circles omniously overhead.

The chipmunk arrives from the west.

>ne
Bluff
You're standing on a wide bluff about fifty feet up a small mountain, overlooking a landscape of sun-blasted plains and craggy hills.  Below you, a train track runs out of a narrow tunnel though the hill.  On the far edge of the bluff you see a strange rock formation, and a path wanders southwest through the brush.  

You see a bundle of small brown sticks.

You can also see a sparker tool here.

The chipmunk arrives from the southwest.

>put tool in bundle
You need to be holding the sparker tool before you can put it into something else.

The chipmunk seems paralyzed in place, caught between fear and desire!

>take tool
Taken.

The chipmunk seems paralyzed in place, caught between fear and desire!

>put tool in bundle
You put the sparker tool into the stick bundle.

The chipmunk seems paralyzed in place, caught between fear and desire!

>put gun in hat
You need to be holding the pistol before you can put it into something else.

The chipmunk seems paralyzed in place, caught between fear and desire!

>wear hat
You put on the hat.

The chipmunk looks at your possessions longingly.

>put acorn on sparker
You put the acorn on the sparker tool.

>enter rocks
You get into the circle of rocks.

A distant wind blows, echoing over the hills.

>z
Time passes.

The chipmunk enthusiastically jumps up onto the sparker to grab the acorn!
A fiery flash and earth-shattering boom rocks you!  The shock wave literally knocks you off your feet, as debris explodes in all directions.
The chipmunk screams and is torn apart by the exposion.
If that weren't enough, you hear a low rumble, and suddenly the ground begins to crack and crumble.  The earth opens up, and entire front of the bluff violently collapses downward, filling the tunnel below!

>stand
You get out of the circle of rocks.

Bluff
You're standing on the edge of a dangerous, collapsed bluff overlooking a landscape of sun-blasted plains and craggy hills.  Below you, a train track runs out of a narrow tunnel though the hill. (Of course, the tunnel is now completely full of rocks and dirt.)  On the far edge of the bluff you see a strange rock formation, and a path wanders southwest through the brush.

>z
Time passes.

>time
Your pocketwatch reads 9:52 am.

>z
Time passes.

>z
Time passes.

The sun mercilessly continues to bake the land.

>z
Time passes.

>time
Your pocketwatch reads 10:07 am.

>z
Time passes.

>time
Your pocketwatch reads 10:26 am.

>z
Time passes.

A train whistles in the distance, bellowing steam!

>z
Time passes.

>z
Time passes.

The train is moving down the track, getting closer.

* * *

>z
Time passes.

>x train
It's a hulking, steam-driven locomotive, with at least ten cars behind it.

>z
Time passes.

The train is approaching the tunnel!

>l
Bluff
You're standing on the edge of a dangerous, collapsed bluff overlooking a landscape of sun-blasted plains and craggy hills.  Below you, a train track runs out of a narrow tunnel though the hill. (Of course, the tunnel is now completely full of rocks and dirt.)  On the far edge of the bluff you see a strange rock formation, and a path wanders southwest through the brush.   

A long train is approaching! 

Seeing the collapsed tunnel, the train engineer yells and slams the brakes!  The giant machine shrieks;  steam and sparks pour from the engine, and the train comes to a stop just inches before the tunnel debris.  You can hear all sorts of panic and screams coming from the train.

In fact, that looks like Muddy himself leaning out of the train window!  He's wildly gesticulating at you.  Is that a a thumbs-up signal he's giving you?

>i
You are carrying:
  a hat (being worn)
    your trusty pistol
  a pocketwatch
  a scrap of paper

>l
Bluff
You're standing on the edge of a dangerous, collapsed bluff overlooking a landscape of sun-blasted plains and craggy hills.  Below you, a train track runs out of a narrow tunnel though the hill. (Of course, the tunnel is now completely full of rocks and dirt.)  On the far edge of the bluff you see a strange rock formation, and a path wanders southwest through the brush.

>i
You are carrying:
  a hat (being worn)
    your trusty pistol
  a pocketwatch
  a scrap of paper

You feel a tap on your back, and you spin around.

.Three guns are pointed in your face.

"We know all about your plan", one of Marshalls states coldly.  "We've been tracking you and Muddy for days.  Keep your hands in the air, and follow us."

You can see that Muddy is here, also held at gunpoint and already handcuffed.  You pause for a moment, consider your options, then decide that death is perhaps worse than being locked in a cell with an angry Muddy.

"Don't worry", Muddy whispers.  "I have a plan..."

    *** You have won ***

Would you like to RESTART, RESTORE a saved game, or QUIT?