Here is an introductory paragraph.  Make it clear that we're in rural Wyoming in 1868... just one year before the first transcontinental railway was completed, and one year after the invention of dynamite.  Dynamite is a new thing.  Player is an anti-hero, attempting to rob a train. 

Robber
An IntroComp 2007 game entry by Ben Collins-Sussman and David Anderson
Release 1 / Serial number 070729 / Inform 7 build 4U67 (I6/v6.31 lib 6/11N) SD

Bluff
You're standing on a wide bluff fitfy feet up a small mountain, overlooking a landscape of sun-blasted plains and craggy hills.  Below you, a train track runs out of a narrow tunnel though the hill.  Multiple paths lead further up the mountain.

>z
Time passes.

* * *

>z
Time passes.

A train whistles in the distance, bellowing steam!

>x train
It's a hulking, steam-driven locomotive, pulling at least ten cars behind it.   You can see it chugging along, getting closer by the second.

The train is moving down the track, getting closer!