BAM!  A mug of ale hits the table, splashing your shoes.  Muddy Charlie slumps back in his chair, eyes you carefully, and starts to chuckle.

"You know your problem?  You don't think big enough."

His expression is familiar.  Last time you saw that look, it was just before you two decided to hijack the mayor's private herd back in 1866.  That didn't work so well.

"What now?" you ask.  "A new idea?"

"Big plans."  He grins widely.  "That new cross-country railroad is almost finished.  It's gonna change everything... bigger trains, more people... and prize cargo."

"A train holdup?  Are you kidding?"

"Relax.  This time we got technology on our side."  He leans close and whispers:  "Made in Sweden... or Germany.  It's big, dangerous, and nobody knows about it yet."

"A new weapon?"

"Dynamic, buddy.  Dynamic Might." 

Trainstopping
An IntroComp 2007 game entry by Ben Collins-Sussman
Release 1 / Serial number 070802 / Inform 7 build 4U67 (I6/v6.31 lib 6/11N) SD

Summit
You wander east, and slowly climb up the mountain.

Here at the top the mountain, the wind blows strong and carries the smell of endless summer.  There are no trees up here, no tall grass, but bits of shrubbery dot the area.  The view is remarkable, though;  you can see for miles around.  A train track clearly extends north into the distance, and a small bluff is visible further down the north face.

A vulture circles omniously overhead.

>x acorn
Um, it's a small, brown nut-like object.

>take acorn
The acorn is far too high to reach.

>take branch
That seems to be a part of the oak tree.

You hear some crickets chirp nearby.

>climb tree
I don't think much is to be achieved by that.

* * *

>close eyes
It is now pitch dark in here!

>time
It's too dark to see your watch.

>open eyes
Dirt Road
This is a dusty trail that wanders off east and west for miles.  The sun blasts down on the back of your neck, but you can smell the cool tang of some pine trees off to the north.  You also spy the lower slopes of a small mountain that way.

>n
You shamble slowly toward the trees.

Copse
At last, some shade!

You're in a section of dense pine forest at the base of a small mountain.  There are cones and needles littered about, and the treetops chatter with birdsong.  The slope continues up the mountain, or back down towards the road.

You can see a pine cone here.

>up
Grassy Plateau
The land opens up into a large green space here, partway up the mountain. The grasses are nearly five feet high, full of life.  A nice place to take a napw if you didn't already have better things to do.

This is a wide field of untamed prairie.  To the east, a the mountain rises up towards its summit, while another hill is faintly visible to the west.  You also can make out a faint trail leading northeast through the brush.

A chipmunk scurries about.

The chipmunk notices something terrifying and freezes in place for a moment.  The chipmunk bolts away, speeding east.

>w
Cliff Edge
You press through the grasses, squinting at the bright sky, then suddenly lose your footing.  You scramble to regain your balance and realize you nearly walked off a cliff.

The edge of the plateau stops abruptly at a chasm that drops nearly one hundred feet.  Luckily, there's a flimsy-looking rope bridge that spans the gap.  It stretches westward to another isolated bluff.

A vulture circles omniously overhead.

The vulture sails off, heading west.

>w
You grab hold of the bridge, but your vertigo gets the best of you.  You're unable to avoid looking down, and you feel yourself start to spin.  The sight is just too much.

>close eyes
It is now pitch dark in here!

* * *

>w
Darkness
It is pitch dark, and you can't see a thing.

>open eyes
Lone Tree Bluff
There's a tree here.

A vulture circles omniously overhead.

>x tree
You can't see any such thing.

* * *

>close eyes
It is now pitch dark in here!

>e
Darkness
It is pitch dark, and you can't see a thing.

A distant wind blows, echoing over the hills.

>e
Darkness
It is pitch dark, and you can't see a thing.

>open eyes
Cliff Edge
You press through the grasses, squinting at the bright sky, then suddenly lose your footing.  You scramble to regain your balance and realize you nearly walked off a cliff.

The edge of the plateau stops abruptly at a chasm that drops nearly one hundred feet.  Luckily, there's a flimsy-looking rope bridge that spans the gap.  It stretches westward to another isolated bluff.

>i
You are carrying:
  a hat (being worn)
  a pocketwatch
  a scrap of paper
  your trusty pistol

>e
Grassy Plateau
The land opens up into a large green space here, partway up the mountain. The grasses are nearly five feet high, full of life.  A nice place to take a napw if you didn't already have better things to do.

This is a wide field of untamed prairie.  To the east, a the mountain rises up towards its summit, while another hill is faintly visible to the west.  You also can make out a faint trail leading northeast through the brush.

A vulture circles omniously overhead.

A chipmunk scurries about.

The chipmunk suddenly shoots you a look of utter fear.  The chipmunk bolts away, speeding northeast.

>e
Summit
You wander east, and slowly climb up the mountain.

Here at the top the mountain, the wind blows strong and carryies the smell of endless summer.  Bits of shrubbery dot the area, and you can see for miles around.  A train track clearly extends north into the distance, and a small bluff is visible further down the north face.

* * *

>shoot acorn
BANG!  You fire a bullet at the acorn with the pistol.

>shoot acorn
BANG!  You fire a bullet at the acorn with the pistol.

>x pistol
It's a mean-looking pistol, good for... persuasion.

It appears to contain two bullets.

>shoot self
BANG!  You fire a bullet at yourself with the pistol.   Murder can be... fun.

Suicide, eh?
You collapses to the ground.

    *** You have died ***

Would you like to RESTART, RESTORE a saved game, or QUIT?

* * *

>shoot acorn
BANG!  You fire a bullet at the acorn with the pistol.

>x gun
It's a mean-looking pistol, good for... persuasion.

It appears to contain three bullets.

* * *

>shoot branch
BANG!  You fire a bullet at the branch with the pistol. 
Embedding a bullet in the huge branch isn't going to do much.

>x branch
It appears that one very tall branch has an acorn hanging from it.

>shoot acorn
BANG!  You fire a bullet at the acorn with the pistol. 
Yikes, that's a small target.  Your bullet sails right past it.

You hear some crickets chirp nearby.

>shoot acorn
BANG!  You fire a bullet at the acorn with the pistol. 
What luck!  You hit a tiny branch, and the acorn tumbles to the ground.

* * *

>shoot branch
BANG!  You fire a bullet at the branch with the pistol. 
Embedding a bullet in the huge branch isn't going to do much.

>shoot acorn
BANG!  You fire a bullet at the acorn with the pistol. 
Yikes, that's a small target.  Your bullet sails right past it.

>shoot acorn
BANG!  You fire a bullet at the acorn with the pistol. 
What luck!  You hit a tiny branch, and the acorn tumbles to the ground.

>l
Lone Tree Bluff
A gigantic oak tree dominates this small bluff.  It's an eruption of countless branches and thick bushy leaves.

You can see an acorn here.

>take acorn
Taken.

* * *

>z
Time passes.

The chipmunk arrives from the east.

>e
You grab hold of the bridge, but your vertigo gets the best of you.  You're unable to avoid looking down, and you feel yourself start to spin.  The sight is just too much.

The chipmunk seems paralyzed in place, caught between fear and desire!

>close eyes
The chipmunk seems paralyzed in place, caught between fear and desire!

It is now pitch dark in here!

>e
Darkness
It is pitch dark, and you can't see a thing.

>open eyes
Cliff Edge
You press through the grasses, squinting at the bright sky, then suddenly lose your footing.  You scramble to regain your balance and realize you nearly walked off a cliff.

The edge of the plateau stops abruptly at a chasm that drops nearly one hundred feet.  Luckily, there's a flimsy-looking rope bridge that spans the gap.  It stretches westward to another isolated bluff.

A chipmunk scurries about.

>x chipmunk
A slippery little varmint.  He appears to be searching for something.

The chipmunk seems paralyzed in place, caught between fear and desire!

>put gun in hat
You put the pistol into the hat.

A distant wind blows, echoing over the hills.

The chipmunk looks at your possessions longingly.

>drop acorn
Dropped.

>z
Time passes.

>z
Time passes.

The chipmunk picks up the acorn.

>remove hat
You take off the hat.

The chipmunk seems paralyzed in place, caught between fear and desire!

The chipmunk puts down the acorn.

>take acorn
Taken.

A distant wind blows, echoing over the hills.

The chipmunk seems paralyzed in place, caught between fear and desire!

>wear hat
You put on the hat.

A brief breeze flaps your clothing.

The chipmunk looks at your possessions longingly.

>jump
You jump on the spot, fruitlessly.

The chipmunk looks at your possessions longingly.

* * *

>shoot vulture
BANG!  You fire a bullet at the vulture with the pistol.   Murder can be... fun.

The vulture collapses to the ground.

>l
Summit
Here at the top the mountain, the wind blows strong and carries the smell of endless summer.  There are no trees up here, no tall grass, but bits of shrubbery dot the area.  The view is remarkable, though;  you can see for miles around.  A train track clearly extends north into the distance, and a small bluff is visible further down the north face.

>x gun
It's a mean-looking pistol, good for... persuasion.

It appears to contain three bullets.

You hear some crickets chirp nearby.

* * *

>x branches
You see nothing special about the branch.

* * *

>climb tree
You're too old for that.  Really.

>x tree
The tree is huge and leafy, but you don't see any fruit.  Just some strong branches.

>x branches
It appears that one very tall branch has an acorn hanging from it.

>take acorn
The acorn is far too high to reach.

* * *

>x tree
The tree is huge and leafy, but you don't see any fruit.  Just some strong branches.

>x branch
You see nothing special about the branch.

* * *

>x branches
It appears that one very tall branch has an acorn hanging from it.

>x acorn
Um, it's a small, brown nut-like object.

A distant wind blows, echoing over the hills.

>take acorn
Taken.

* * *

>n
You shamble slowly toward the trees.

Copse
At last, some shade!

You're in a section of dense pine forest at the base of a small mountain.  There are cones and needles littered about, and the treetops chatter with birdsong.  The slope continues up the mountain, or back down towards the road.

You can see a pine cone here.

>up
Grassy Plateau
The land opens up into a large green space here, partway up the mountain. The grasses are nearly five feet high, full of life.  A nice place to take a napw if you didn't already have better things to do.

This is a wide field of untamed prairie.  To the east, a the mountain rises up towards its summit, while another hill is faintly visible to the west.  You also can make out a faint trail leading northeast through the brush.

A chipmunk scurries about.

The chipmunk notices something terrifying and freezes in place for a moment.  The chipmunk bolts away, speeding west.

>w
Cliff Edge
You press through the grasses, squinting at the bright sky, then suddenly lose your footing.  You scramble to regain your balance and realize you nearly walked off a cliff.

The edge of the plateau stops abruptly at a chasm that drops nearly one hundred feet.  Luckily, there's a flimsy-looking rope bridge that spans the gap.  It stretches westward to another isolated bluff.

A chipmunk scurries about.

The chipmunk turns its gaze dramatically at you;  is that an orchestra playing?  The chipmunk bolts away, speeding west.

>w
You grab hold of the bridge, but your vertigo gets the best of you.  You're unable to avoid looking down, and you feel yourself start to spin.  The sight is just too much.

>close eyes
You hear some crickets chirp nearby.

It is now pitch dark in here!

>i
You are carrying:
  a hat (being worn)
  a pocketwatch
  a scrap of paper
  your trusty pistol

>w
Darkness
It is pitch dark, and you can't see a thing.

>listen
You hear the gentle creaking of the bridge, and the wind whistling below your feet.

>open eyes
Rope Bridge
You're in the middle of the rope bridge.

* * *

>close eyes
You hear some crickets chirp nearby.

It is now pitch dark in here!

>w
Darkness
It is pitch dark, and you can't see a thing.

>look
Darkness
It is pitch dark, and you can't see a thing.

>w
Darkness
It is pitch dark, and you can't see a thing.

You hear some crickets chirp nearby.

* * *

>w
Darkness
It is pitch dark, and you can't see a thing.

>open eyes
Rope Bridge
You're in the middle of the rope bridge.  The space below makes you nauseous.

>e
You're paralyzed with fear.  The height is unbearable.

>w
You're paralyzed with fear.  The height is unbearable.

>listen
You hear the gentle creaking of the bridge, and the wind whistling below your feet.

>smell
You smell nothing unexpected.

>close eyes
It is now pitch dark in here!

>w
Darkness
It is pitch dark, and you can't see a thing.

A train whistles in the distance, bellowing steam!

>open eyes
Lone Tree Bluff

>e
You grab hold of the bridge, but your vertigo gets the best of you.  You're unable to avoid looking down, and you feel yourself start to spin.  The sight is just too much.

* * *

>w
Cliff Edge
You press through the grasses, squinting at the bright sky, then suddenly lose your footing.  You scramble to regain your balance and realize you nearly walked off a cliff.

The edge of the plateau stops abruptly at a chasm that drops nearly one hundred feet.  Luckily, there's a flimsy-looking rope bridge that spans the gap.  It stretches westward to another isolated bluff.

A chipmunk scurries about.

The chipmunk turns its gaze dramatically at you;  is that an orchestra playing?  The chipmunk bolts away, speeding west.

>close eyes
It is now pitch dark in here!

>time
Your pocketwatch reads 9:19 am.

>w
Darkness
It is pitch dark, and you can't see a thing.

Some sort of insect buzzes by.

>x paper
It is pitch dark, and you can't see a thing.

>x hat
It is pitch dark, and you can't see a thing.

* * *

>take acorn
The acorn is far too high to reach.

* * *

>l
Lone Tree Bluff
A gigantic oak tree dominates this small bluff.  It's an eruption of countless branches and thick bushy leaves.

You can see an acorn here.

* * *

>shoot hat
BANG!  You fire a bullet at the hat with the pistol.