BAM!  A mug of ale hits the table, splashing your shoes.  Muddy Charlie slumps back in his chair, eyes you carefully, and starts to chuckle.

"You know your problem?  You don't think big enough."

His expression is familiar.  Last time you saw that look, it was just before you two decided to hijack the mayor's private herd back in 1866.  That didn't work so well.

"What now?" you ask.  "A new idea?"

"Big plans."  He grins widely.  "That new cross-country railroad is almost finished.  It's gonna change everything... bigger trains, more people... and prize cargo."

"A train holdup?  Are you kidding?"

"Relax.  This time we got technology on our side."  He leans close and whispers:  "Made in Sweden... or Germany.  It's big, dangerous, and nobody knows about it yet."

"A new weapon?"

"Dynamic, buddy.  Dynamic Might." 

Trainstopping
An IntroComp 2007 game entry by Ben Collins-Sussman
Release 1 / Serial number 070802 / Inform 7 build 4U67 (I6/v6.31 lib 6/11N) SD

Dirt Road
Muddy wasn't particularly clear in his instructions, but you're pretty sure this is the trail he wanted you to follow this morning.  Now that your horse has inexplicably bolted, you can use all the luck you can get.

This is a dusty trail that wanders off east and west for miles.  The sun blasts down on the back of your neck, but you can smell the cool tang of some pine trees off to the north.  You also spy the lower slopes of a small mountain that way.

>n
You shamble slowly toward the trees.

Copse
At last, some shade!

You're in a section of dense pine forest at the base of a small mountain.  There are cones and needles littered about, and the treetops chatter with birdsong.  The slope continues up the mountain, or back down towards the road.

You can see a pine cone here.

>up
Grassy Plateau
The land opens up into a large green space here, partway up the mountain. The grasses are nearly five feet high, full of life.  A nice place to take a napw if you didn't already have better things to do.

This is a wide field of untamed prairie.  To the east, a the mountain rises up towards its summit, while another hill is faintly visible to the west.  You also can make out a faint trail leading northeast through the brush.

You can see a chipmunk here.

Some sort of insect buzzes by.

The chipmunk spins around, looks at you, then panics.  The chipmunk bolts away, speeding west.

High above, a vulture glides into the area.

>ne
Bluff
You're standing on a wide bluff about fifty feet up a small mountain, overlooking a landscape of sun-blasted plains and craggy hills.  Below you, a train track runs out of a narrow tunnel though the hill.  On the far edge of the bluff you see a strange rock formation, and a path wanders southwest through the brush.  

You see a bundle of small brown sticks.

You can also see a sparker tool here.

>take sparker and bundle
sparker tool: Taken.
stick bundle: Taken.

>put tool in bundle
You put the sparker tool into the stick bundle.

The vulture sails off, heading down.

>psuh bundle
That's not a verb I recognise.

>push tool
The sparker tool shoots a few sparks from one end.
A fiery flash and earth-shattering boom rocks you!  The shock wave literally knocks you off your feet, as debris explodes in all directions.
Unfortunately, being unprotected, you were engulfed in the flames.

    *** Ouch. ***

In that game you scored 0 out of a possible 0, in 6 turns.

Would you like to RESTART, RESTORE a saved game, or QUIT?

* * *

>ne
Bluff
You're standing on a wide bluff about fifty feet up a small mountain, overlooking a landscape of sun-blasted plains and craggy hills.  Below you, a train track runs out of a narrow tunnel though the hill.  On the far edge of the bluff you see a strange rock formation, and a path wanders southwest through the brush.  

You see a bundle of small brown sticks.

You can also see a sparker tool here.

>take bundle and tool
stick bundle: Taken.
sparker tool: Taken.

>put tool in bundle
You put the sparker tool into the stick bundle.

>enter rocks
You get into the circle of rocks.

A distant wind blows, echoing over the hills.

>push tool
The sparker tool shoots a few sparks from one end.
A fiery flash and earth-shattering boom rocks you!  The shock wave literally knocks you off your feet, as debris explodes in all directions.
Unfortunately, being unprotected, you were engulfed in the flames.

    *** Ouch. ***

In that game you scored 0 out of a possible 0, in 7 turns.

Would you like to RESTART, RESTORE a saved game, or QUIT?

* * *

>ne
Bluff
You're standing on a wide bluff about fifty feet up a small mountain, overlooking a landscape of sun-blasted plains and craggy hills.  Below you, a train track runs out of a narrow tunnel though the hill.  On the far edge of the bluff you see a strange rock formation, and a path wanders southwest through the brush.  

You see a bundle of small brown sticks.

You can also see a sparker tool here.

>z
Time passes.

A brief breeze flaps your clothing.

>z
Time passes.

>z
Time passes.

High above, a vulture glides into the area.

>z
Time passes.

>z
Time passes.

A distant wind blows, echoing over the hills.

The vulture sails off, heading down.

>z
Time passes.

A train whistles in the distance, bellowing steam!

>l
Bluff
You're standing on a wide bluff about fifty feet up a small mountain, overlooking a landscape of sun-blasted plains and craggy hills.  Below you, a train track runs out of a narrow tunnel though the hill.  On the far edge of the bluff you see a strange rock formation, and a path wanders southwest through the brush.   

 A long train is approaching! 

You see a bundle of small brown sticks.

You can also see a sparker tool here.

>l
Bluff
You're standing on a wide bluff about fifty feet up a small mountain, overlooking a landscape of sun-blasted plains and craggy hills.  Below you, a train track runs out of a narrow tunnel though the hill.  On the far edge of the bluff you see a strange rock formation, and a path wanders southwest through the brush.   

 A long train is approaching! 

You see a bundle of small brown sticks.

You can also see a sparker tool here.

High above, a vulture glides into the area.

The train is moving down the track, getting closer.

>l
Bluff
You're standing on a wide bluff about fifty feet up a small mountain, overlooking a landscape of sun-blasted plains and craggy hills.  Below you, a train track runs out of a narrow tunnel though the hill.  On the far edge of the bluff you see a strange rock formation, and a path wanders southwest through the brush.   

 A long train is approaching! 

A vulture circles omniously overhead.

You see a bundle of small brown sticks.

You can also see a sparker tool here.

>l
Bluff
You're standing on a wide bluff about fifty feet up a small mountain, overlooking a landscape of sun-blasted plains and craggy hills.  Below you, a train track runs out of a narrow tunnel though the hill.  On the far edge of the bluff you see a strange rock formation, and a path wanders southwest through the brush.   

 A long train is approaching! 

A vulture circles omniously overhead.

You see a bundle of small brown sticks.

You can also see a sparker tool here.

You hear some crickets chirp nearby.

>l
Bluff
You're standing on a wide bluff about fifty feet up a small mountain, overlooking a landscape of sun-blasted plains and craggy hills.  Below you, a train track runs out of a narrow tunnel though the hill.  On the far edge of the bluff you see a strange rock formation, and a path wanders southwest through the brush.   

 A long train is approaching! 

A vulture circles omniously overhead.

You see a bundle of small brown sticks.

You can also see a sparker tool here.

>l
Bluff
You're standing on a wide bluff about fifty feet up a small mountain, overlooking a landscape of sun-blasted plains and craggy hills.  Below you, a train track runs out of a narrow tunnel though the hill.  On the far edge of the bluff you see a strange rock formation, and a path wanders southwest through the brush.   

 A long train is approaching! 

A vulture circles omniously overhead.

You see a bundle of small brown sticks.

You can also see a sparker tool here.

The train is approaching the tunnel!

>l
Bluff
You're standing on a wide bluff about fifty feet up a small mountain, overlooking a landscape of sun-blasted plains and craggy hills.  Below you, a train track runs out of a narrow tunnel though the hill.  On the far edge of the bluff you see a strange rock formation, and a path wanders southwest through the brush.   

 A long train is approaching! 

A vulture circles omniously overhead.

You see a bundle of small brown sticks.

You can also see a sparker tool here.

The train disappears into the tunnel below you, echoing loudly, leaving behind a wisp of steam.

>l
Bluff
You're standing on a wide bluff about fifty feet up a small mountain, overlooking a landscape of sun-blasted plains and craggy hills.  Below you, a train track runs out of a narrow tunnel though the hill.  On the far edge of the bluff you see a strange rock formation, and a path wanders southwest through the brush.  

A vulture circles omniously overhead.

You see a bundle of small brown sticks.

You can also see a sparker tool here.

The vulture sails off, heading southwest.

>z
Time passes.

>z
Time passes.

You realize that the train is gone.  Muddy is gonna be real mad.

    *** You failed the mission. ***

In that game you scored 0 out of a possible 0, in 23 turns.

Would you like to RESTART, RESTORE a saved game, or QUIT?

* * *

>ne
Bluff
You're standing on a wide bluff about fifty feet up a small mountain, overlooking a landscape of sun-blasted plains and craggy hills.  Below you, a train track runs out of a narrow tunnel though the hill.  On the far edge of the bluff you see a strange rock formation, and a path wanders southwest through the brush.  

You see a bundle of small brown sticks.

You can also see a sparker tool here.

>enter rocks
You get into the circle of rocks.

You hear some crickets chirp nearby.

>shoot bundle
BANG!  You shoot the stick bundle with the pistol. 
A fiery flash and earth-shattering boom rocks you!  The shock wave literally knocks you off your feet, as debris explodes in all directions.
If that weren't enough, you hear a low rumble, and suddenly the ground begins to crack and crumble.  The earth opens up, and entire front of the bluff violently collapses downward, filling the tunnel below!

>z
Time passes.

>z
Time passes.

A distant wind blows, echoing over the hills.

A train whistles in the distance, bellowing steam!

>z
Time passes.

>x train
It's a hulking, steam-driven locomotive, with at least ten cars behind it.

The train is moving down the track, getting closer.

>l
Bluff (in the circle of rocks)
You're standing on the edge of a dangerous, collapsed bluff overlooking a landscape of sun-blasted plains and craggy hills.  Below you, a train track runs out of a narrow tunnel though the hill. (Of course, the tunnel is now completely full of rocks and dirt.)  On the far edge of the bluff you see a strange rock formation, and a path wanders southwest through the brush.

You can see a sparker tool here.

* * *

>n
You shamble slowly toward the trees.

Copse
At last, some shade!

You're in a section of dense pine forest at the base of a small mountain.  There are cones and needles littered about, and the treetops chatter with birdsong.  The slope continues up the mountain, or back down towards the road.

You can see a pine cone here.

>n
You can't go that way.

>up
Grassy Plateau
The land opens up into a large green space here, partway up the mountain. The grasses are nearly five feet high, full of life.  A nice place to take a napw if you didn't already have better things to do.

This is a wide field of untamed prairie.  To the east, a the mountain rises up towards its summit, while another hill is faintly visible to the west.  You also can make out a faint trail leading northeast through the brush.

You can see a chipmunk here.

The chipmunk spins around, looks at you, then panics.  The chipmunk bolts away, speeding east.

>put gun in hat
You put the pistol into the hat.

>e
Summit
We're very high up here.

A vulture circles omniously overhead.

You can also see a chipmunk here.

The chipmunk sniffs around, mostly ignoring you.

The vulture sails off, heading west.

>take gun
You can't see any such thing.

>i
You are carrying:
  a hat (being worn)
    your trusty pistol
  a pocketwatch
  a scrap of paper

The chipmunk sniffs around, mostly ignoring you.

>remove pistol from hat
You can't see any such thing.

>x hat
A wide-brimmed hat to protect you from the sun, and which clearly marks you as a denizen of the plains.

The chipmunk sniffs around, mostly ignoring you.

>look inside hat
In the hat is a pistol.

The chipmunk sniffs around, mostly ignoring you.

* * *

>n
You shamble slowly toward the trees.

Copse
At last, some shade!

You're in a section of dense pine forest at the base of a small mountain.  There are cones and needles littered about, and the treetops chatter with birdsong.  The slope continues up the mountain, or back down towards the road.

You can see a pine cone here.

>ne
You can't go that way.

>up
Grassy Plateau
The land opens up into a large green space here, partway up the mountain. The grasses are nearly five feet high, full of life.  A nice place to take a napw if you didn't already have better things to do.

This is a wide field of untamed prairie.  To the east, a the mountain rises up towards its summit, while another hill is faintly visible to the west.  You also can make out a faint trail leading northeast through the brush.

You can see a chipmunk here.

The chipmunk suddenly shoots you a look of utter fear.  The chipmunk bolts away, speeding east.

>ne
Bluff
You're standing on a wide bluff about fifty feet up a small mountain, overlooking a landscape of sun-blasted plains and craggy hills.  Below you, a train track runs out of a narrow tunnel though the hill.  On the far edge of the bluff you see a strange rock formation, and a path wanders southwest through the brush.  

You see a bundle of small brown sticks.

You can also see a sparker tool here.

>shoot bundle
BANG!  You shoot the stick bundle with the pistol. 
A fiery flash and earth-shattering boom rocks you!  The shock wave literally knocks you off your feet, as debris explodes in all directions.
yourself screams and is torn apart by the exposion.

Some sort of insect buzzes by.

It is now pitch dark in here!

* * *

>shoot hat
BANG!  You shoot the hat with the pistol.

>shoot self
BANG!  You shoot yourself with the pistol.   Murder can be... fun.

>n
You shamble slowly toward the trees.

Copse
Lots of trees.

>up
Grassy Plateau
Ooh, it's grassy here.

A vulture circles omniously overhead.

You can also see a chipmunk here.

>shoot chipmunk
BANG!  You shoot the chipmunk with the pistol.   Murder can be... fun.

>l
Grassy Plateau
Ooh, it's grassy here.

A vulture circles omniously overhead.

You can also see a chipmunk here.

* * *

>shoot hat
BANG!  You shoot the hat with the pistol.

>n
You shamble slowly toward the trees.

Copse
Lots of trees.

>up
Grassy Plateau
Ooh, it's grassy here.

A vulture circles omniously overhead.

You can also see a chipmunk here.

The vulture sails off, heading east.

>shoot vulture
BANG!  You shoot the vulture with the pistol.   Murder can be... fun.

A distant wind blows, echoing over the hills.

>x vulture
Large and black, with a huge wingspan.   He seems to hang in the air, waiting for something to happen.

The vulture sails off, heading west.

* * *

>up
Grassy Plateau
Ooh, it's grassy here.

A vulture circles omniously overhead.

You can also see a chipmunk here.

The vulture sails off, heading east.

>shoot chipmunk
BANG!  You shoot the chipmunk with the pistol.   Murder can be... fun.

the chipmunk collapses to the ground.

>i
You are carrying:
  a hat (being worn)
  a pocketwatch
  a scrap of paper

High above, a vulture glides into the area.

>l
Grassy Plateau
Ooh, it's grassy here.

A vulture circles omniously overhead.

You can also see a chipmunk here.

The vulture sails off, heading down.

>down
Copse
Lots of trees.

A vulture circles omniously overhead.

>shoot vulture
You need some sort of firearm to do that.

* * *

>shoot chipmunk
BANG!  You shoot the chipmunk with the pistol.   Murder can be... fun.

the chipmunk collapses to the ground.

>x chipmunk
You can't see any such thing.

* * *

>shoot hat
BANG!  You shoot the hat with the pistol.

>x hat
A wide-brimmed hat to protect you from the sun, and which clearly marks you as a denizen of the plains.

>i
You are carrying:
  a hat (being worn)
  a pocketwatch
  a scrap of paper
  your trusty pistol

>n
You shamble slowly toward the trees.

Copse
Lots of trees.

>up
Grassy Plateau
Ooh, it's grassy here.

You can see a chipmunk here.

>shoot chipmunk
BANG!  You shoot the chipmunk with the pistol.   Murder can be... fun.

>l
Grassy Plateau
Ooh, it's grassy here.

>x chipmunk
You can't see any such thing.

>x gun
It's a mean-looking pistol.

It appears to contain two bullets.

>ne
Bluff
You're standing on a wide bluff about fifty feet up a small mountain, overlooking a landscape of sun-blasted plains and craggy hills.  Below you, a train track runs out of a narrow tunnel though the hill.  On the far edge of the bluff you see a strange rock formation, and a path wanders southwest through the brush.

You can see a stick bundle here.

>sw
Grassy Plateau
Ooh, it's grassy here.

>s
You can't go that way.

>showme
Grassy Plateau - room
    yourself - player-character
        hat (worn) - open container
        pocketwatch
        scrap of paper
        pistol - gun

>showme vulture
You can't see any such thing.

>w
Cliff Edge
Ooh, scary cliff.

>e
Grassy Plateau
Ooh, it's grassy here.

>e
Summit
We're very high up here.

A distant wind blows, echoing over the hills.

A train whistles in the distance, bellowing steam!

>w
Grassy Plateau
Ooh, it's grassy here.

>s
You can't go that way.

You hear the chugging of an approaching train.

>down
Copse
Lots of trees.

>s
Dirt Road
This is a dusty trail that wanders off east and west for miles.  The sun blasts down on the back of your neck, but you can smell the cool tang of some pine trees off to the north.  You also spy the lower slopes of a small mountain that way.

>n
You shamble slowly toward the trees.

Copse
Lots of trees.

A distant wind blows, echoing over the hills.

>n
You shamble slowly toward the trees.

You can't go that way.

The Mountain shakes as a train rumbles through it!

>up
Grassy Plateau
Ooh, it's grassy here.

>ne
Bluff
You're standing on a wide bluff about fifty feet up a small mountain, overlooking a landscape of sun-blasted plains and craggy hills.  Below you, a train track runs out of a narrow tunnel though the hill.  On the far edge of the bluff you see a strange rock formation, and a path wanders southwest through the brush.

You can see a stick bundle here.

>z
Time passes.

High above, a vulture glides into the area.

>shoot vulture
BANG!  You shoot the vulture with the pistol.   Murder can be... fun.

>x vulture
You can't see any such thing.

* * *

>shoot self
BANG!  You shoot yourself with the pistol.   Murder can be... fun.

* * *

>time
Your pocketwatch reads 10:15 am.

>z
Time passes.

>z
Time passes.

A distant wind blows, echoing over the valley.

>z
Time passes.

>z
Time passes.

A train whistles in the distance, bellowing steam!

* * *

>z
Time passes.

>z
Time passes.

You hear the chugging of an approaching train.

>z
Time passes.

>z
Time passes.

The Mountain shakes as a train rumbles through it!

>z
Time passes.

>restart
Are you sure you want to restart?

* * *

>put gun in hat
You put the pistol into the hat.

>n
You shamble slowly toward the trees.

Copse
At last, some shade!

You're in a section of dense pine forest at the base of a small mountain.  There are cones and needles littered about, and the treetops chatter with birdsong.  The slope continues up the mountain, or back down towards the road.

You can see a pine cone here.

>up
Grassy Plateau
The land opens up into a large green space here, partway up the mountain. The grasses are nearly five feet high, full of life.  A nice place to take a napw if you didn't already have better things to do.

This is a wide field of untamed prairie.  To the east, a the mountain rises up towards its summit, while another hill is faintly visible to the west.  You also can make out a faint trail leading northeast through the brush.

You can see a chipmunk here.

The chipmunk sniffs around, mostly ignoring you.

High above, a vulture glides into the area.

>ne
Bluff
You're standing on a wide bluff about fifty feet up a small mountain, overlooking a landscape of sun-blasted plains and craggy hills.  Below you, a train track runs out of a narrow tunnel though the hill.  On the far edge of the bluff you see a strange rock formation, and a path wanders southwest through the brush.  

You see a bundle of small brown sticks.

You can also see a sparker tool here.

>take bundle
Taken.

>sw
Grassy Plateau
This is a wide field of untamed prairie.  To the east, a the mountain rises up towards its summit, while another hill is faintly visible to the west.  You also can make out a faint trail leading northeast through the brush.

A vulture circles omniously overhead.

You can also see a chipmunk here.

The chipmunk sniffs around, mostly ignoring you.

>shoot bundle
You need some sort of firearm to do that.

A distant wind blows, echoing over the hills.

The chipmunk sniffs around, mostly ignoring you.

>w
Cliff Edge
Ooh, scary cliff.

You can see an acorn here.

>take acorn
Taken.

A brief breeze flaps your clothing.

>e
Grassy Plateau
This is a wide field of untamed prairie.  To the east, a the mountain rises up towards its summit, while another hill is faintly visible to the west.  You also can make out a faint trail leading northeast through the brush.

A vulture circles omniously overhead.

You can also see a chipmunk here.

The vulture sails off, heading down.

>drop acorn
Dropped.

The chipmunk picks up the acorn.

High above, a vulture glides into the area.

>shoot bundle
You need some sort of firearm to do that.

The vulture sails off, heading down.

>take gun
You can't see any such thing.

>remove gun from hat
You can't see any such thing.

>look in hat
In the hat is a pistol.

A train whistles in the distance, bellowing steam!

>take gun
You can't see any such thing.

>take gun from hat
You can't see any such thing.

>take pistol
You can't see any such thing.

>open hat
That's not something you can open.

The sun mercilessly continues to bake the land.

>x gun
You can't see any such thing.

>remove hat
You take off the hat.

The chipmunk seems paralyzed in place, caught between fear and desire!

You hear the chugging of an approaching train.

>take gun
Taken.

The chipmunk seems paralyzed in place, caught between fear and desire!

>shoot bundle
BANG!  You shoot the stick bundle with the pistol. 
A fiery flash and earth-shattering boom rocks you!  The shock wave literally knocks you off your feet, as debris explodes in all directions.
Unfortunately, being unprotected, the flames engulfed the chipmunk.

>l
Grassy Plateau
This is a wide field of untamed prairie.  To the east, a the mountain rises up towards its summit, while another hill is faintly visible to the west.  You also can make out a faint trail leading northeast through the brush.

>x chipmunk
You can't see any such thing.

* * *

>up
Grassy Plateau
The land opens up into a large green space here, partway up the mountain. The grasses are nearly five feet high, full of life.  A nice place to take a napw if you didn't already have better things to do.

This is a wide field of untamed prairie.  To the east, a the mountain rises up towards its summit, while another hill is faintly visible to the west.  You also can make out a faint trail leading northeast through the brush.

You can see a chipmunk here.

The chipmunk sniffs around, mostly ignoring you.

High above, a vulture glides into the area.

>w
Cliff Edge
Ooh, scary cliff.

You can see an acorn here.

>take acorn
Taken.

>e
Grassy Plateau
This is a wide field of untamed prairie.  To the east, a the mountain rises up towards its summit, while another hill is faintly visible to the west.  You also can make out a faint trail leading northeast through the brush.

You can see a chipmunk here.

>drop acorn
Dropped.

The chipmunk picks up the acorn.

>take off hat
You take off the hat.

The chipmunk seems paralyzed in place, caught between fear and desire!

>take gun
Taken.

The chipmunk seems paralyzed in place, caught between fear and desire!

>ne
Bluff
You're standing on a wide bluff about fifty feet up a small mountain, overlooking a landscape of sun-blasted plains and craggy hills.  Below you, a train track runs out of a narrow tunnel though the hill.  On the far edge of the bluff you see a strange rock formation, and a path wanders southwest through the brush.  

You see a bundle of small brown sticks.

You can also see a sparker tool here.

* * *

>take bundle
Taken.

>sw
Grassy Plateau
This is a wide field of untamed prairie.  To the east, a the mountain rises up towards its summit, while another hill is faintly visible to the west.  You also can make out a faint trail leading northeast through the brush.

You can see a chipmunk here.

The chipmunk seems paralyzed in place, caught between fear and desire!

High above, a vulture glides into the area.

>shoot bundle
BANG!  You shoot the stick bundle with the pistol. 
A fiery flash and earth-shattering boom rocks you!  The shock wave literally knocks you off your feet, as debris explodes in all directions.
the vulture screams and is torn apart by the exposion.
Unfortunately, being unprotected, you were engulfed by the flames.

    *** Ouch ***

In that game you scored 0 out of a possible 0, in 13 turns.

Would you like to RESTART, RESTORE a saved game, or QUIT?

* * *

>n
You can't go that way.

>w
You can't go that way.

>up
Grassy Plateau
The land opens up into a large green space here, partway up the mountain. The grasses are nearly five feet high, full of life.  A nice place to take a napw if you didn't already have better things to do.

This is a wide field of untamed prairie.  To the east, a the mountain rises up towards its summit, while another hill is faintly visible to the west.  You also can make out a faint trail leading northeast through the brush.

You can see a chipmunk here.

The chipmunk sniffs around, mostly ignoring you.

>w
Cliff Edge
Ooh, scary cliff.

You can see an acorn here.

* * *

>take acorn
Taken.

A brief breeze flaps your clothing.

>e
Grassy Plateau
This is a wide field of untamed prairie.  To the east, a the mountain rises up towards its summit, while another hill is faintly visible to the west.  You also can make out a faint trail leading northeast through the brush.

You can see a chipmunk here.

>remove hat
You take off the hat.

The chipmunk seems paralyzed in place, caught between fear and desire!

>shoot bundle
You can't see any such thing.

>ne
Bluff
You're standing on a wide bluff about fifty feet up a small mountain, overlooking a landscape of sun-blasted plains and craggy hills.  Below you, a train track runs out of a narrow tunnel though the hill.  On the far edge of the bluff you see a strange rock formation, and a path wanders southwest through the brush.  

You see a bundle of small brown sticks.

You can also see a sparker tool here.

* * *

>take bundle
Taken.

>sw
Grassy Plateau
This is a wide field of untamed prairie.  To the east, a the mountain rises up towards its summit, while another hill is faintly visible to the west.  You also can make out a faint trail leading northeast through the brush.

A vulture circles omniously overhead.

You can also see a chipmunk here.

The chipmunk seems paralyzed in place, caught between fear and desire!

>shoot bundle
You need some sort of firearm to do that.

The chipmunk seems paralyzed in place, caught between fear and desire!

The vulture sails off, heading down.

A train whistles in the distance, bellowing steam!

>take gun
Taken.

The chipmunk seems paralyzed in place, caught between fear and desire!

High above, a vulture glides into the area.

>shoot bundle
BANG!  You shoot the stick bundle with the pistol. 
A fiery flash and earth-shattering boom rocks you!  The shock wave literally knocks you off your feet, as debris explodes in all directions.
Unfortunately, being unprotected, the flames engulfed the vulture.

    *** Ouch ***

In that game you scored 0 out of a possible 0, in 15 turns.

Would you like to RESTART, RESTORE a saved game, or QUIT?

* * *

>put gun in hat
You put the pistol into the hat.

>x hat
A wide-brimmed hat to protect you from the sun, and which clearly marks you as a denizen of the plains.  In the hat you see a pistol.

>wear hat
You're already wearing that!

* * *

>x paper
The paper contains scribblings from the Little Snoreing train station, about twenty miles down the trail.  The train only comes through town once per day, and by your partner's calculations, it should speeding through this mountain around 10:30am.  Angry smeared handwriting screams "MOUNTAIN, DYNAMIC MIGHT ETHZF... TRAIN TUNNEL ^$*@ DON'T BELLATE."