Here is an introductory paragraph.  Make it clear that we're in rural Wyoming in 1868... just one year before the first transcontinental railway was completed, and one year after the invention of dynamite.  Dynamite is a new thing.  Player is an anti-hero, attempting to rob a train. 
Dirt Road
This is a dusty road.

Robber
An IntroComp 2007 game entry by Ben Collins-Sussman and David Anderson
Release 1 / Serial number 070730 / Inform 7 build 4U67 (I6/v6.31 lib 6/11N) SD

Dirt Road
This is a dusty road.

>n
Copse
Lots of trees.

>up
Grassy Plateau
Ooh, it's grassy here.

A slippery little varmint.  He appears to be searching for something.

>ne
Bluff
You're standing on a wide bluff fitfy feet up a small mountain, overlooking a landscape of sun-blasted plains and craggy hills.  Below you, a train track runs out of a narrow tunnel though the hill.  Multiple paths lead further up the mountain.

>z
Time passes.

>z
Time passes.

The train is now entering the tunnel!

>x train
It's a hulking, steam-driven locomotive, pulling at least ten cars behind it.  

The train disappears into the tunnel below you, echoing loudly, leaving behind a wisp of steam.

>z
Time passes.

>sw
Grassy Plateau
Ooh, it's grassy here.

>z
Time passes.

>showme
Grassy Plateau - room
    yourself - player-character
        hat (worn) - open container
        pocketwatch
        scrap of paper
        pistol - gun

>showme chipmunk
chipmunk - animal
location: out of play

* * *

>up
Grassy Plateau
Ooh, it's grassy here.

A slippery little varmint.  He appears to be searching for something.

>shoot chipmunk
BANG!  You shoot the chipmunk with the pistol.   Murder can be... fun.

>l
Grassy Plateau
Ooh, it's grassy here.

You can see a chipmunk here.

>x chipmunk
You see nothing special about the chipmunk.

* * *

>n
Copse
Lots of trees.

>shoot self
BANG!  You shoot yourself with the pistol.   Murder can be... fun.

>up
Grassy Plateau
Ooh, it's grassy here.

>z
Time passes.

>z
Time passes.

A chipmunk scampers into the area.

>shoot chipmunk
BANG!  You shoot the chipmunk with the pistol.   Murder can be... fun.

>time
Your pocketwatch reads 10:25 am.

The chipmunk scurries off, heading northeast.

>z
Time passes.

* * *

>n
Copse
Lots of trees.

>z
Time passes.

>n
You can't go that way.

A distant wind blows, echoing over the valley.

>z
Time passes.

>up
Grassy Plateau
Ooh, it's grassy here.

>z
Time passes.

A chipmunk scampers into the area.

>x  chipmunk
You see nothing special about the chipmunk.

The chipmunk scurries off, heading down.

>down
Copse
Lots of trees.

You can see a chipmunk here.

The chipmunk scurries off, heading up.

>up
Grassy Plateau
Ooh, it's grassy here.

You can see a chipmunk here.

The chipmunk scurries off, heading northeast.

A train whistles in the distance, bellowing steam!

>ne
Bluff
You're standing on a wide bluff fitfy feet up a small mountain, overlooking a landscape of sun-blasted plains and craggy hills.  Below you, a train track runs out of a narrow tunnel though the hill.  Multiple paths lead further up the mountain.

You can see a chipmunk here.

The chipmunk scurries off, heading east.

>e
Rock Circle
What an interesting circle of rocks!

You can see a chipmunk here.

The chipmunk scurries off, heading west.

You hear the chugging of an approaching train.

* * *

Here is an introductory paragraph.  Make it clear that we're in rural Wyoming in 1868... just one year before the first transcontinental railway was completed, and one year after the invention of dynamite.  Dynamite is a new thing.  Player is an anti-hero, attempting to rob a train. 
Dirt Road
This is a dusty road.

Robber
An IntroComp 2007 game entry by Ben Collins-Sussman and David Anderson
Release 1 / Serial number 070730 / Inform 7 build 4U67 (I6/v6.31 lib 6/11N) SD

Dirt Road
This is a dusty road.

>up
You can't go that way.

>n
Copse
Lots of trees.

>up
Grassy Plateau
Ooh, it's grassy here.

You can see a chipmunk here.

>ne
Bluff
You're standing on a wide bluff fitfy feet up a small mountain, overlooking a landscape of sun-blasted plains and craggy hills.  Below you, a train track runs out of a narrow tunnel though the hill.  Multiple paths lead further up the mountain.

You can see a chipmunk here.

The chipmunk scurries off, heading east.

>e
Rock Circle
What an interesting circle of rocks!

You can see a chipmunk here.

>shoot chipmunk
BANG!  You shoot the chipmunk with the pistol.

>look
Rock Circle
What an interesting circle of rocks!

You can see a chipmunk here.

>x chipmunk
You see nothing special about the chipmunk.

The chipmunk scurries off, heading up.

>up
Summit
We're very high up here.

You can see a chipmunk here.

The chipmunk scurries off, heading down.

>down
Rock Circle
What an interesting circle of rocks!

You can see a chipmunk here.

* * *

>up
Grassy Plateau
Ooh, it's grassy here.

You can see a chipmunk here.

>x chipmunk
A slippery little varmint.  He appears to be searching for something.

The chipmunk scurries off, heading east.

>shoot chipmunk
You can't see any such thing.

>shoot self
BANG!  You shoot yourself with the pistol.   Murder can be... fun.

I beg your pardon?

I beg your pardon?

* * *

>up
Grassy Plateau
Ooh, it's grassy here.

You can see a chipmunk here.

>z
Time passes.

>z
Time passes.

The chipmunk scurries off, heading northeast.

>ne
Bluff
You're standing on a wide bluff fitfy feet up a small mountain, overlooking a landscape of sun-blasted plains and craggy hills.  Below you, a train track runs out of a narrow tunnel though the hill.  Multiple paths lead further up the mountain.

You can see a chipmunk here.

>x chipmunk
You see nothing special about the chipmunk.

The chipmunk scurries off, heading east.

>e
Rock Circle
What an interesting circle of rocks!

You can see a chipmunk here.

The chipmunk scurries off, heading west.

>w
Bluff
You're standing on a wide bluff fitfy feet up a small mountain, overlooking a landscape of sun-blasted plains and craggy hills.  Below you, a train track runs out of a narrow tunnel though the hill.  Multiple paths lead further up the mountain.

You can see a chipmunk here.

>z
Time passes.

The chipmunk scurries off, heading east.

>e
Rock Circle
What an interesting circle of rocks!

You can see a chipmunk here.

>z
Time passes.

>shoot chipmunk
BANG!  You shoot the chipmunk with the pistol.

The chipmunk scurries off, heading west.

A train whistles in the distance, bellowing steam!

* * *

>up
Grassy Plateau
Ooh, it's grassy here.

You can see a chipmunk here.

>down
Copse
Lots of trees.

You can see a chipmunk here.

>shoot chipmunk
BANG!  You shoot the chipmunk with the pistol.   Looks like... murder. 
The chipmunk scurries off, heading south.

>shoot hat
BANG!  You shoot the hat with the pistol.  Not a very useful thing to do.

* * *

Here is an introductory paragraph.  Make it clear that we're in rural Wyoming in 1868... just one year before the first transcontinental railway was completed, and one year after the invention of dynamite.  Dynamite is a new thing.  Player is an anti-hero, attempting to rob a train. 
Dirt Road
This is a dusty road.

Robber
An IntroComp 2007 game entry by Ben Collins-Sussman and David Anderson
Release 1 / Serial number 070730 / Inform 7 build 4U67 (I6/v6.31 lib 6/11N) SD

Dirt Road
This is a dusty road.

>z
Time passes.

>time
Your pocketwatch reads 10:25 am.

>z
Time passes.

* * *

>z
Time passes.

A train whistles in the distance, bellowing steam!

>z
Time passes.

You hear the train getting closer.
You hear the distant chugging of an approaching train.
The Mountain shakes as a train rumbles through it.

>z
Time passes.

You hear the train getting closer.
You hear the distant chugging of an approaching train.
The Mountain shakes as a train rumbles through it.

>time
Your pocketwatch reads 10:31 am.

You hear the train getting closer.
You hear the distant chugging of an approaching train.
The Mountain shakes as a train rumbles through it.

>z
Time passes.

A distant wind blows, echoing over the valley.

You hear the train getting closer.
You hear the distant chugging of an approaching train.
The Mountain shakes as a train rumbles through it.

>z
Time passes.

You hear the train getting closer.
You hear the distant chugging of an approaching train.
The Mountain shakes as a train rumbles through it.

>z
Time passes.

A distant wind blows, echoing over the valley.

You hear the train getting closer.
You hear the distant chugging of an approaching train.
The Mountain shakes as a train rumbles through it.

>z
Time passes.

>time
Your pocketwatch reads 10:36 am.

A distant wind blows, echoing over the valley.

* * *

>z
Time passes.

>z
Time passes.

A train whistles in the distance, bellowing steam!
You hear the chugging of an approaching train.
The Mountain shakes as a train rumbles through it!

* * *

>z
Time passes.

A distant wind blows, echoing over the valley.

>x train
It's a hulking, steam-driven locomotive, pulling at least ten cars behind it.   You can see it chugging along, getting closer by the second.

The train is moving down the track, getting closer!

>enter train
You can't reach into Distant Track.

>touch train
You can't reach into Distant Track.

>touch train
You can't reach into Distant Track.

>touch train
You can't reach into Distant Track.

The train is now entering the tunnel.

>touch train
You can't reach into Track Below.

* * *

Here is an introductory paragraph.  Make it clear that we're in rural Wyoming in 1868... just one year before the first transcontinental railway was completed, and one year after the invention of dynamite.  Dynamite is a new thing.  Player is an anti-hero, attempting to rob a train. 
Dirt Road
This is a dusty road.

Robber
An IntroComp 2007 game entry by Ben Collins-Sussman and David Anderson
Release 1 / Serial number 070730 / Inform 7 build 4U67 (I6/v6.31 lib 6/11N) SD

Dirt Road
This is a dusty road.

>s
You can't go that way.

>sw
Grassy Plateau
Ooh, it's grassy here.

>w
Cliff Edge
Ooh, scary cliff.

>w
You can't go that way.

>e
Grassy Plateau
Ooh, it's grassy here.

>s
You can't go that way.

>down
Copse
Lots of trees.

>down
You can't go that way.

>s
Dirt Road
This is a dusty road.

>i
You are carrying:
  a hat (being worn)
  a pocketwatch
  a pistol

>shoot road
You can't see any such thing.

>shoot self
BANG!  You shoot yourself with the pistol.

>z
Time passes.

>time
Your pocketwatch reads 9:28 am.

* * *

Here is an introductory paragraph.  Make it clear that we're in rural Wyoming in 1868... just one year before the first transcontinental railway was completed, and one year after the invention of dynamite.  Dynamite is a new thing.  Player is an anti-hero, attempting to rob a train. 
Dirt Road
This is a dusty road.

Robber
An IntroComp 2007 game entry by Ben Collins-Sussman and David Anderson
Release 1 / Serial number 070730 / Inform 7 build 4U67 (I6/v6.31 lib 6/11N) SD

Dirt Road
This is a dusty road.

>time
Your pocketwatch reads 10:15 am.

* * *

Here is an introductory paragraph.  Make it clear that we're in rural Wyoming in 1868... just one year before the first transcontinental railway was completed, and one year after the invention of dynamite.  Dynamite is a new thing.  Player is an anti-hero, attempting to rob a train. 
Dirt Road
This is a dusty road.

Robber
An IntroComp 2007 game entry by Ben Collins-Sussman and David Anderson
Release 1 / Serial number 070730 / Inform 7 build 4U67 (I6/v6.31 lib 6/11N) SD

Dirt Road
This is a dusty road.

>i
You are carrying:
  a hat (being worn)
  a pocketwatch
  a scrap of paper
  your trusty pistol

>x paper
You see nothing special about the scrap of paper.

>x scrap
You see nothing special about the scrap of paper.

* * *

>i
You are carrying:
  a hat (being worn)
  a pocketwatch
  a scrap of paper
  your trusty pistol

>time
Your pocketwatch reads 9:16 am.

>x watch
It's a rusty wind-up timepiece, handed down from your uncle.  It currently reads 9:17 am.

>time
Your pocketwatch reads 9:18 am.

>wait until 10:26 am
I only understood you as far as wanting to wait.

>wait
Time passes.

>x hat
A wide-brimmed hat to protect you from the sun, and which clearly marks you as a denizen of the plains.

>x pistol
It's a mean-looking pistol.

It appears to contain four bullets.

>x paper
The paper contains scribblings from the Little Snoreing train station, about twenty miles down the trail.  The train only comes through town once per day, and by your partner's calculations, it should swing through this mountain around 10:30am.  Angry smeared handwriting screams "mountain tzqchutunnel, zlcgggdyna-nite.  DON'T BEELATE."

>x paper
The paper contains scribblings from the Little Snoreing train station, about twenty miles down the trail.  The train only comes through town once per day, and by your partner's calculations, it should swing through this mountain around 10:30am.  Angry smeared handwriting screams "mountain tzqchutunnel, zlcgggdyna-nite.  DON'T BEELATE."

>time
Your pocketwatch reads 9:24 am.

A distant wind blows, echoing over the valley.

>z
Time passes.

>wait 20 minutes
I only understood you as far as wanting to wait.

>z
Time passes.

>time
Your pocketwatch reads 9:32 am.

>z
Time passes.

>time
Your pocketwatch reads 9:37 am.

>z
Time passes.