>n
You shamble slowly toward the trees.

Copse
At last, some shade!

You're in a section of dense pine forest at the base of a small mountain.  There are cones and needles littered about, and the treetops chatter with birdsong.  The slope continues up the mountain, or back down towards the road.

You can see a pine cone here.

>up
Grassy Plateau
The land opens up into a large green space here, partway up the mountain. The grasses are nearly five feet high, full of life.  A nice place to take a napw if you didn't already have better things to do.

This is a wide field of untamed prairie.  To the east, a the mountain rises up towards its summit, while another hill is faintly visible to the west.  You also can make out a faint trail leading northeast through the brush.

A vulture circles omniously overhead.

You can also see a chipmunk here.

The chipmunk spins around, looks at you, then panics.  The chipmunk bolts away, speeding west.

>ne
Bluff
You're standing on a wide bluff about fifty feet up a small mountain, overlooking a landscape of sun-blasted plains and craggy hills.  Below you, a train track runs out of a narrow tunnel though the hill.  On the far edge of the bluff you see a strange rock formation, and a path wanders southwest through the brush.  

You see a bundle of small brown sticks.

You can also see a sparker tool here.

>enter rocks
You get into the circle of rocks.

>shoot bundle
BANG!  You shoot the stick bundle with the pistol. 
A fiery flash and earth-shattering boom rocks you!  The shock wave literally knocks you off your feet, as debris explodes in all directions.
If that weren't enough, you hear a low rumble, and suddenly the ground begins to crack and crumble.  The earth opens up, and entire front of the bluff violently collapses downward, filling the tunnel below!

You hear some crickets chirp nearby.

>restart
Are you sure you want to restart?

* * *

>ne
Bluff
You're standing on a wide bluff about fifty feet up a small mountain, overlooking a landscape of sun-blasted plains and craggy hills.  Below you, a train track runs out of a narrow tunnel though the hill.  On the far edge of the bluff you see a strange rock formation, and a path wanders southwest through the brush.  

You see a bundle of small brown sticks.

You can also see a sparker tool here.

>shoot bundle
BANG!  You shoot the stick bundle with the pistol. 
A fiery flash and earth-shattering boom rocks you!  The shock wave literally knocks you off your feet, as debris explodes in all directions.
Unfortunately, being unprotected, you were engulfed by the flames.

    *** Ouch ***

In that game you scored 0 out of a possible 0, in 4 turns.

Would you like to RESTART, RESTORE a saved game, or QUIT?

* * *

>put gun in hat
You put the pistol into the hat.

The vulture sails off, heading down.

>w
Cliff Edge
Ooh, scary cliff.

You can see a chipmunk and an acorn here.

The chipmunk picks up the acorn.

>take acorn
That seems to belong to the chipmunk.

A brief breeze flaps your clothing.

>restart
Are you sure you want to restart?

* * *

>restart
Are you sure you want to restart?

* * *

>n
You shamble slowly toward the trees.

Copse
At last, some shade!

You're in a section of dense pine forest at the base of a small mountain.  There are cones and needles littered about, and the treetops chatter with birdsong.  The slope continues up the mountain, or back down towards the road.

You can see a pine cone here.

I beg your pardon?

>l
Copse
You're in a section of dense pine forest at the base of a small mountain.  There are cones and needles littered about, and the treetops chatter with birdsong.  The slope continues up the mountain, or back down towards the road.

You can see a pine cone here.

You must supply a noun.

>take cone
Taken.

You must supply a noun.

* * *

>n
You shamble slowly toward the trees.

Copse
At last, some shade!

You're in a section of dense pine forest at the base of a small mountain.  There are cones and needles littered about, and the treetops chatter with birdsong.  The slope continues up the mountain, or back down towards the road.

You can see a pine cone here.

>put gun in hat
You put the pistol into the hat.

Some sort of insect buzzes by.

>up
Grassy Plateau
The land opens up into a large green space here, partway up the mountain. The grasses are nearly five feet high, full of life.  A nice place to take a napw if you didn't already have better things to do.

This is a wide field of untamed prairie.  To the east, a the mountain rises up towards its summit, while another hill is faintly visible to the west.  You also can make out a faint trail leading northeast through the brush.

A chipmunk scurries about.

The chipmunk sniffs around, mostly ignoring you.

>w
Cliff Edge
Ooh, scary cliff.

A vulture circles omniously overhead.

You can also see an acorn here.

The vulture sails off, heading east.

>take acorn
Taken.

>e
Grassy Plateau
This is a wide field of untamed prairie.  To the east, a the mountain rises up towards its summit, while another hill is faintly visible to the west.  You also can make out a faint trail leading northeast through the brush.

A chipmunk scurries about.

The chipmunk sees the acorn.

>i
You are carrying:
  an acorn
  a hat (being worn)
    your trusty pistol
  a pocketwatch
  a scrap of paper

The chipmunk sees the acorn.

* * *

>up
Grassy Plateau
The land opens up into a large green space here, partway up the mountain. The grasses are nearly five feet high, full of life.  A nice place to take a napw if you didn't already have better things to do.

This is a wide field of untamed prairie.  To the east, a the mountain rises up towards its summit, while another hill is faintly visible to the west.  You also can make out a faint trail leading northeast through the brush.

A chipmunk scurries about.

The chipmunk sniffs around, mostly ignoring you.

>e
Summit
We're very high up here.

A vulture circles omniously overhead.

The vulture sails off, heading west.

>w
Grassy Plateau
This is a wide field of untamed prairie.  To the east, a the mountain rises up towards its summit, while another hill is faintly visible to the west.  You also can make out a faint trail leading northeast through the brush.

A vulture circles omniously overhead.

A chipmunk scurries about.

The chipmunk sniffs around, mostly ignoring you.

>w
Cliff Edge
Ooh, scary cliff.

You can see an acorn here.

High above, a vulture glides into the area.

>take acorn
Taken.

The chipmunk arrives from the east.

>e
Grassy Plateau
This is a wide field of untamed prairie.  To the east, a the mountain rises up towards its summit, while another hill is faintly visible to the west.  You also can make out a faint trail leading northeast through the brush.

The chipmunk arrives from the west.

>remove hat
You take off the hat.

The chipmunk seems paralyzed in place, caught between fear and desire!

>e
Summit
We're very high up here.

The chipmunk arrives from the west.

>x chipmunk
A slippery little varmint.  He appears to be searching for something.

The chipmunk seems paralyzed in place, caught between fear and desire!

>wear hat
You put on the hat.

The chipmunk looks at your possessions longingly.

>w
Grassy Plateau
This is a wide field of untamed prairie.  To the east, a the mountain rises up towards its summit, while another hill is faintly visible to the west.  You also can make out a faint trail leading northeast through the brush.

High above, a vulture glides into the area.

The chipmunk arrives from the east.

A train whistles in the distance, bellowing steam!

>ne
Bluff
You're standing on a wide bluff about fifty feet up a small mountain, overlooking a landscape of sun-blasted plains and craggy hills.  Below you, a train track runs out of a narrow tunnel though the hill.  On the far edge of the bluff you see a strange rock formation, and a path wanders southwest through the brush.   

A long train is approaching! 

You see a bundle of small brown sticks.

You can also see a sparker tool here.

The chipmunk arrives from the southwest.

>take bundle and sparker
stick bundle: Taken.
sparker tool: Taken.

The chipmunk looks at your possessions longingly.

The train is moving down the track, getting closer.

>put tool in bundle
You put the sparker tool into the stick bundle.

The chipmunk looks at your possessions longingly.

>drop bundle
You... gingerly... put the bundle on the ground, and step away.

Dropped.

The chipmunk looks at your possessions longingly.

>i
You are carrying:
  an acorn
  a hat (being worn)
    your trusty pistol
  a pocketwatch
  a scrap of paper

The chipmunk looks at your possessions longingly.

>l
Bluff
You're standing on a wide bluff about fifty feet up a small mountain, overlooking a landscape of sun-blasted plains and craggy hills.  Below you, a train track runs out of a narrow tunnel though the hill.  On the far edge of the bluff you see a strange rock formation, and a path wanders southwest through the brush.   

A long train is approaching! 

A chipmunk scurries about.

You can also see a stick bundle (in which is a sparker tool) here.

The chipmunk looks at your possessions longingly.

The train is approaching the tunnel!

>put acorn on tool
You put the acorn on the sparker tool.

The chipmunk jumps up onto the sparker to grab the acorn.  BOOM.

The train disappears into the tunnel below you, echoing loudly, leaving behind a wisp of steam.

>quit
Are you sure you want to quit?

* * *

>hide gun in hat
That's not a verb I recognise.

>put gun in hat
You put the pistol into the hat.

* * *

>n
You shamble slowly toward the trees.

Copse
At last, some shade!

You're in a section of dense pine forest at the base of a small mountain.  There are cones and needles littered about, and the treetops chatter with birdsong.  The slope continues up the mountain, or back down towards the road.

You can see a pine cone here.

>up
Grassy Plateau
The land opens up into a large green space here, partway up the mountain. The grasses are nearly five feet high, full of life.  A nice place to take a napw if you didn't already have better things to do.

This is a wide field of untamed prairie.  To the east, a the mountain rises up towards its summit, while another hill is faintly visible to the west.  You also can make out a faint trail leading northeast through the brush.

A vulture circles omniously overhead.

You can also see a chipmunk here.

The chipmunk sniffs around, mostly ignoring you.

>w
Cliff Edge
Ooh, scary cliff.

You can see an acorn here.

* * *

>take acorn
Taken.

>e
Grassy Plateau
This is a wide field of untamed prairie.  To the east, a the mountain rises up towards its summit, while another hill is faintly visible to the west.  You also can make out a faint trail leading northeast through the brush.

A vulture circles omniously overhead.

You can also see a chipmunk here.

>drop acorn
Dropped.

The chipmunk picks up the acorn.

>l
Grassy Plateau
This is a wide field of untamed prairie.  To the east, a the mountain rises up towards its summit, while another hill is faintly visible to the west.  You also can make out a faint trail leading northeast through the brush.

A vulture circles omniously overhead.

You can also see a chipmunk here.

The vulture sails off, heading west.

>drop acorn
You haven't got that.

>remove hat
You take off the hat.

The chipmunk seems paralyzed in place, caught between fear and desire!

>take gun
Taken.

The chipmunk seems paralyzed in place, caught between fear and desire!

* * *

>n
You shamble slowly toward the trees.

Copse
At last, some shade!

You're in a section of dense pine forest at the base of a small mountain.  There are cones and needles littered about, and the treetops chatter with birdsong.  The slope continues up the mountain, or back down towards the road.

You can see a pine cone here.

>up
Grassy Plateau
The land opens up into a large green space here, partway up the mountain. The grasses are nearly five feet high, full of life.  A nice place to take a napw if you didn't already have better things to do.

This is a wide field of untamed prairie.  To the east, a the mountain rises up towards its summit, while another hill is faintly visible to the west.  You also can make out a faint trail leading northeast through the brush.

A chipmunk scurries about.

A distant wind blows, echoing over the hills.

The chipmunk sniffs around, mostly ignoring you.

>w
Cliff Edge
Ooh, scary cliff.

You can see an acorn here.

>take acorn
Taken.

The chipmunk arrives from the east.

* * *

>e
Grassy Plateau
This is a wide field of untamed prairie.  To the east, a the mountain rises up towards its summit, while another hill is faintly visible to the west.  You also can make out a faint trail leading northeast through the brush.

The chipmunk arrives from the west.

>drop acorn
Dropped.

The chipmunk picks up the acorn.

>ne
Bluff
You're standing on a wide bluff about fifty feet up a small mountain, overlooking a landscape of sun-blasted plains and craggy hills.  Below you, a train track runs out of a narrow tunnel though the hill.  On the far edge of the bluff you see a strange rock formation, and a path wanders southwest through the brush.  

You see a bundle of small brown sticks.

You can also see a sparker tool here.

>take bundle
Taken.

High above, a vulture glides into the area.

>sw
Grassy Plateau
This is a wide field of untamed prairie.  To the east, a the mountain rises up towards its summit, while another hill is faintly visible to the west.  You also can make out a faint trail leading northeast through the brush.

You can see a chipmunk here.

>drop bundle
You... gingerly... put the bundle on the ground, and step away.

Dropped.

>i
You are carrying:
  a hat (being worn)
    your trusty pistol
  a pocketwatch
  a scrap of paper

>l
Grassy Plateau
This is a wide field of untamed prairie.  To the east, a the mountain rises up towards its summit, while another hill is faintly visible to the west.  You also can make out a faint trail leading northeast through the brush.

You can see a stick bundle (empty) and a chipmunk here.

High above, a vulture glides into the area.

A train whistles in the distance, bellowing steam!

>x chipmunk
A slippery little varmint.  He appears to be searching for something.

>remove hat
You take off the hat.

The chipmunk seems paralyzed in place, caught between fear and desire!

The vulture sails off, heading down.

You hear the chugging of an approaching train.

>take gun
Taken.

The chipmunk seems paralyzed in place, caught between fear and desire!

>shoot bundle
BANG!  You shoot the stick bundle with the pistol. 
A fiery flash and earth-shattering boom rocks you!  The shock wave literally knocks you off your feet, as debris explodes in all directions.
Unfortunately, being unprotected, you were engulfed by the flames.

    *** Ouch ***

In that game you scored 0 out of a possible 0, in 17 turns.

Would you like to RESTART, RESTORE a saved game, or QUIT?

* * *

>drop acorn
Dropped.

The chipmunk picks up the acorn.

>take off hat
You take off the hat.

The chipmunk seems paralyzed in place, caught between fear and desire!

The chipmunk puts down the acorn.

>take acorn
Taken.

The chipmunk seems paralyzed in place, caught between fear and desire!

High above, a vulture glides into the area.

>wear hat
You put on the hat.

>l
Grassy Plateau
This is a wide field of untamed prairie.  To the east, a the mountain rises up towards its summit, while another hill is faintly visible to the west.  You also can make out a faint trail leading northeast through the brush.

A vulture circles omniously overhead.

A chipmunk scurries about.

>drop acorn
Dropped.

The chipmunk picks up the acorn.

>remove hat
You take off the hat.

The chipmunk seems paralyzed in place, caught between fear and desire!

The chipmunk puts down the acorn.

A train whistles in the distance, bellowing steam!

>wear hat
You put on the hat.

A distant wind blows, echoing over the hills.

The chipmunk picks up the acorn.

>remove hat
You take off the hat.

The chipmunk seems paralyzed in place, caught between fear and desire!

The chipmunk puts down the acorn.

You hear the chugging of an approaching train.

>take acorn
Taken.

A distant wind blows, echoing over the hills.

The chipmunk seems paralyzed in place, caught between fear and desire!

The vulture sails off, heading down.

>wear hat
You put on the hat.

>l
Grassy Plateau
This is a wide field of untamed prairie.  To the east, a the mountain rises up towards its summit, while another hill is faintly visible to the west.  You also can make out a faint trail leading northeast through the brush.

A chipmunk scurries about.

A brief breeze flaps your clothing.

>showme
Grassy Plateau - room
    yourself - player-character
        acorn
        hat (worn) - open container
            *pistol - gun
        pocketwatch
        scrap of paper
    chipmunk - animal
* denotes things which are not in scope

>restart
Are you sure you want to restart?

* * *

>take off hat
You take off the hat.

The chipmunk seems paralyzed in place, caught between fear and desire!

The chipmunk puts down the acorn.

>take gun
Taken.

The chipmunk seems paralyzed in place, caught between fear and desire!

* * *

>e
Grassy Plateau
This is a wide field of untamed prairie.  To the east, a the mountain rises up towards its summit, while another hill is faintly visible to the west.  You also can make out a faint trail leading northeast through the brush.

The chipmunk arrives from the west.

>ne
Bluff
You're standing on a wide bluff about fifty feet up a small mountain, overlooking a landscape of sun-blasted plains and craggy hills.  Below you, a train track runs out of a narrow tunnel though the hill.  On the far edge of the bluff you see a strange rock formation, and a path wanders southwest through the brush.  

You see a bundle of small brown sticks.

You can also see a sparker tool here.

The chipmunk arrives from the southwest.

>l
Bluff
You're standing on a wide bluff about fifty feet up a small mountain, overlooking a landscape of sun-blasted plains and craggy hills.  Below you, a train track runs out of a narrow tunnel though the hill.  On the far edge of the bluff you see a strange rock formation, and a path wanders southwest through the brush.  

A chipmunk scurries about.

You see a bundle of small brown sticks.

You can also see a sparker tool here.

A brief breeze flaps your clothing.

The chipmunk looks at your possessions longingly.

>take bundle and sparker
stick bundle: Taken.
sparker tool: Taken.

The chipmunk looks at your possessions longingly.

>put tool in bundle
You put the sparker tool into the stick bundle.

Some sort of insect buzzes by.

The chipmunk looks at your possessions longingly.

>drop bundle
You... gingerly... put the bundle on the ground, and step away.

Dropped.

The chipmunk looks at your possessions longingly.

>put acorn on bundle
Putting things on the stick bundle would achieve nothing.

The chipmunk looks at your possessions longingly.

High above, a vulture glides into the area.

>drop acorn
Dropped.

The chipmunk picks up the acorn.

A train whistles in the distance, bellowing steam!

>remove hat
You take off the hat.

The chipmunk seems paralyzed in place, caught between fear and desire!

The chipmunk puts down the acorn.

>take acorn
Taken.

The chipmunk seems paralyzed in place, caught between fear and desire!

The vulture sails off, heading southwest.

The train is moving down the track, getting closer.

>wear hat
You put on the hat.

The chipmunk looks at your possessions longingly.

>put acorn on sparker
You put the acorn on the sparker tool.

The chipmunk enthusiastically jumps up onto the sparker to grab the acorn!
A fiery flash and earth-shattering boom rocks you!  The shock wave literally knocks you off your feet, as debris explodes in all directions.
Unfortunately, being unprotected, you were engulfed by the flames.

    *** Ouch ***

In that game you scored 0 out of a possible 0, in 17 turns.

Would you like to RESTART, RESTORE a saved game, or QUIT?

* * *

>n
You can't go that way.

>up
Grassy Plateau
The land opens up into a large green space here, partway up the mountain. The grasses are nearly five feet high, full of life.  A nice place to take a napw if you didn't already have better things to do.

This is a wide field of untamed prairie.  To the east, a the mountain rises up towards its summit, while another hill is faintly visible to the west.  You also can make out a faint trail leading northeast through the brush.

A vulture circles omniously overhead.

A chipmunk scurries about.

The chipmunk sniffs around, mostly ignoring you.

>w
Cliff Edge
Ooh, scary cliff.

You can see an acorn here.

>take acorn
Taken.

High above, a vulture glides into the area.

>e
Grassy Plateau
This is a wide field of untamed prairie.  To the east, a the mountain rises up towards its summit, while another hill is faintly visible to the west.  You also can make out a faint trail leading northeast through the brush.

A chipmunk scurries about.

A brief breeze flaps your clothing.