BAM!  A mug of ale hits the table, splashing your shoes.  Muddy Charlie slumps back in his chair, eyes you carefully, and starts to chuckle.

"You know your problem?  You don't think big enough."

His expression is familiar.  Last time you saw that look, it was just before you two decided to hijack the mayor's private herd back in 1866.  That didn't work so well.

"What now?" you ask.  "A new idea?"

"Big plans."  He grins widely.  "That new cross-country railroad is almost finished.  It's gonna change everything... bigger trains, more people... and prize cargo."

"A train holdup?  Are you kidding?"

"Relax.  This time we got technology on our side."  He leans close and whispers:  "Made in Sweden... or Germany.  It's big, dangerous, and nobody knows about it yet."

"A new weapon?"

"Dynamic, buddy.  Dynamic Might." 

Trainstopping
An IntroComp 2007 game entry by Ben Collins-Sussman
Release 1 / Serial number 070801 / Inform 7 build 4U67 (I6/v6.31 lib 6/11N) SD

Dirt Road
Muddy wasn't particularly clear in his instructions, but you're pretty sure this is the trail he wanted you to follow this morning.  Now that your horse has inexplicably bolted, you can use all the luck you can get.

This is a dusty trail that wanders off east and west for miles.  The sun blasts down on the back of your neck, but you can smell the cool tang of some pine trees off to the north.  You also spy the lower slopes of a small mountain that way.

>n
You shamble slowly toward the trees.

Copse
At last, some shade!

You're in a section of dense pine forest at the base of a small mountain.  There are cones and needles littered about, and the treetops chatter with birdsong.  The slope continues up the mountain, or back down towards the road.

You can see a pine cone here.

>up
Grassy Plateau
The land opens up into a large green space here, partway up the mountain. The grasses are nearly five feet high, full of life.  A nice place to take a napw if you didn't already have better things to do.

This is a wide field of untamed prairie.  To the east, a the mountain rises up towards its summit, while another hill is faintly visible to the west.  You also can make out a faint trail leading northeast through the brush.

A vulture circles omniously overhead.

You can also see a chipmunk here.

The chipmunk notices something terrifying and freezes in place for a moment.  The chipmunk bolts away, speeding northeast.

>ne
Bluff
You're standing on a wide bluff about fifty feet up a small mountain, overlooking a landscape of sun-blasted plains and craggy hills.  Below you, a train track runs out of a narrow tunnel though the hill.  On the far edge of the bluff you see a strange rock formation, and a path wanders southwest through the brush.

You see a bundle of small brown sticks.

You can also see a chipmunk and a sparker tool here.

The chipmunk notices something terrifying and freezes in place for a moment.  The chipmunk bolts away, speeding down.

>enter rock
You can't see any such thing.

>enter rocks
You get into the circle of rocks.

>shoot bundle
BANG!  You shoot the stick bundle with the pistol. 
A fiery flash and earth-shattering boom rocks you!  The shock wave literally knocks you off your feet, as debris explodes in all directions.
If that weren't enough, you hear a low rumble, and suddenly the ground begins to crack and crumble.  The earth opens up, and entire front of the bluff violently collapses downward, filling the tunnel below!

>exit
You get out of the circle of rocks.

Bluff
You're standing on the edge of a dangerous, collapsed bluff overlooking a landscape of sun-blasted plains and craggy hills.  Below you, a train track runs out of a narrow tunnel though the hill. (Of course, the tunnel is now completely full of rocks and dirt.)  On the far edge of the bluff you see a strange rock formation, and a path wanders southwest through the brush.

You can see a sparker tool here.

A distant wind blows, echoing over the hills.

>restart
Are you sure you want to restart?

* * *

>ne
Bluff
You're standing on a wide bluff about fifty feet up a small mountain, overlooking a landscape of sun-blasted plains and craggy hills.  Below you, a train track runs out of a narrow tunnel though the hill.  On the far edge of the bluff you see a strange rock formation, and a path wanders southwest through the brush.

You see a bundle of small brown sticks.

You can also see a chipmunk and a sparker tool here.

The chipmunk notices something terrifying and freezes in place for a moment.  The chipmunk bolts away, speeding down.

>take sticks
Taken.

>take tool
Taken.

>put tool in bundle
You put the sparker tool into the stick bundle.

>push tool
The sparker tool shoots a few sparks from one end.
A fiery flash and earth-shattering boom rocks you!  The shock wave literally knocks you off your feet, as debris explodes in all directions.

>i
You are carrying:
  a hat (being worn)
  a pocketwatch
  a scrap of paper
  your trusty pistol

* * *

>ne
Bluff
You're standing on a wide bluff about fifty feet up a small mountain, overlooking a landscape of sun-blasted plains and craggy hills.  Below you, a train track runs out of a narrow tunnel though the hill.  On the far edge of the bluff you see a strange rock formation, and a path wanders southwest through the brush.

You see a bundle of small brown sticks.

You can also see a chipmunk and a sparker tool here.

The chipmunk notices something terrifying and freezes in place for a moment.  The chipmunk bolts away, speeding down.

>take tool
Taken.

>take bundle
Taken.

>put tool in bundle
You put the sparker tool into the stick bundle.

>push tool
The sparker tool shoots a few sparks from one end.
BOOM

* * *

>ne
Bluff
You're standing on a wide bluff about fifty feet up a small mountain, overlooking a landscape of sun-blasted plains and craggy hills.  Below you, a train track runs out of a narrow tunnel though the hill.  On the far edge of the bluff you see a strange rock formation, and a path wanders southwest through the brush.

You see a bundle of small brown sticks.

You can also see a chipmunk and a sparker tool here.

The chipmunk notices something terrifying and freezes in place for a moment.  The chipmunk bolts away, speeding down.

>shoot bundle
BANG!  You shoot the stick bundle with the pistol. 
A fiery flash and earth-shattering boom rocks you!  The shock wave literally knocks you off your feet, as debris explodes in all directions.
Unfortunately, being unprotected, you were engulfed in the flames.

    *** Ouch. ***

In that game you scored 0 out of a possible 0, in 4 turns.

Would you like to RESTART, RESTORE a saved game, or QUIT?

* * *

>ne
Bluff
You're standing on a wide bluff about fifty feet up a small mountain, overlooking a landscape of sun-blasted plains and craggy hills.  Below you, a train track runs out of a narrow tunnel though the hill.  On the far edge of the bluff you see a strange rock formation, and a path wanders southwest through the brush.

You see a bundle of small brown sticks.

You can also see a chipmunk and a sparker tool here.

The chipmunk notices something terrifying and freezes in place for a moment.  The chipmunk bolts away, speeding down.

>take sparker and bundle
sparker tool: Taken.
stick bundle: Taken.

* * *

>ne
Bluff
You're standing on a wide bluff about fifty feet up a small mountain, overlooking a landscape of sun-blasted plains and craggy hills.  Below you, a train track runs out of a narrow tunnel though the hill.  On the far edge of the bluff you see a strange rock formation, and a path wanders southwest through the brush.

You see a bundle of small brown sticks.

You can also see a chipmunk and a sparker tool here.

The chipmunk notices something terrifying and freezes in place for a moment.  The chipmunk bolts away, speeding down.

>take bundle and tool
stick bundle: Taken.
sparker tool: Taken.

* * *

>put tool in bundle
You put the sparker tool into the stick bundle.

>enter rocks
You get into the circle of rocks.

>push tool
The sparker tool shoots a few sparks from one end.
A fiery flash and earth-shattering boom rocks you!  The shock wave literally knocks you off your feet, as debris explodes in all directions.

* * *

>n
You shamble slowly toward the trees.

Copse
At last, some shade!

You're in a section of dense pine forest at the base of a small mountain.  There are cones and needles littered about, and the treetops chatter with birdsong.  The slope continues up the mountain, or back down towards the road.

You can see a pine cone here.

>x tree
It's a particularly tall pine tree.

>climb tree
I don't think much is to be achieved by that.

* * *

>n
You shamble slowly toward the trees.

Copse
At last, some shade!

You're in a section of dense pine forest at the base of a small mountain.  There are cones and needles littered about, and the treetops chatter with birdsong.  The slope continues up the mountain, or back down towards the road.

You can see a pine cone here.

>climb tree
You're too old for that.  No jewel-encrusted egg for you.

>x tree
It's a particularly tall pine tree.

>n
You can't go that way.

>up
Grassy Plateau
The land opens up into a large green space here, partway up the mountain.   The grasses are nearly five feet high, full of life.  A nice place to take a nap, if you didn't already have better things to do.

This is a wide field of untamed prairie.  To the east, a the mountain rises up towards its summit, while another hill is faintly visible to the west.  You also can make out a faint trail leading northeast through the brush.

You can see a chipmunk here.

The chipmunk turns its gaze dramatically at you;  is that an orchestra playing?  The chipmunk bolts away, speeding west.

>e
Summit
We're very high up here.

>w
Grassy Plateau
This is a wide field of untamed prairie.  To the east, a the mountain rises up towards its summit, while another hill is faintly visible to the west.  You also can make out a faint trail leading northeast through the brush.

>ne
Bluff
You're standing on a wide bluff about fifty feet up a small mountain, overlooking a landscape of sun-blasted plains and craggy hills.  Below you, a train track runs out of a narrow tunnel though the hill.  On the far edge of the bluff you see a strange rock formation, and a path wanders southwest through the brush.

A vulture circles omniously overhead.

You see a bundle of small brown sticks.

You can also see a sparker tool here.

The vulture sails off, heading down.

>x tool
You've seen something like this before;  it looks like a spring-loaded pair of scissors with a small plate at one end.  If you apply a pound or two of pressure to the plate, the device slowly clamps together into a long stick.  When you push the plate quickly, rapid friction on the opposite tip can produce sparks.

>push tool
The sparker tool shoots a few sparks from one end.

* * *

>up
You can't go that way.

>n
You shamble slowly toward the trees.

Copse
At last, some shade!

You're in a section of dense pine forest at the base of a small mountain.  There are cones and needles littered about, and the treetops chatter with birdsong.  The slope continues up the mountain, or back down towards the road.

You can see a pine cone here.

>up
Grassy Plateau
The land opens up into a large green space here, partway up the mountain. The grasses are nearly five feet high, full of life.  A nice place to take a napw if you didn't already have better things to do.

This is a wide field of untamed prairie.  To the east, a the mountain rises up towards its summit, while another hill is faintly visible to the west.  You also can make out a faint trail leading northeast through the brush.

You can see a chipmunk here.

The chipmunk spins around, looks at you, then panics.  The chipmunk bolts away, speeding west.

High above, a vulture glides into the area.

>ne
Bluff
You're standing on a wide bluff about fifty feet up a small mountain, overlooking a landscape of sun-blasted plains and craggy hills.  Below you, a train track runs out of a narrow tunnel though the hill.  On the far edge of the bluff you see a strange rock formation, and a path wanders southwest through the brush.

You see a bundle of small brown sticks.

You can also see a sparker tool here.

>shoot bundle
BANG!  You shoot the stick bundle with the pistol. 
A fiery flash and earth-shattering boom rocks you!  The shock wave literally knocks you off your feet, as debris explodes in all directions.
Unfortunately, being unprotected, you were engulfed in the flames.

    *** Ouch. ***

In that game you scored 0 out of a possible 0, in 5 turns.

Would you like to RESTART, RESTORE a saved game, or QUIT?

* * *

>shoot hat
BANG!  You shoot the hat with the pistol.

* * *

>shoot self
BANG!  You shoot yourself with the pistol.   Murder can be... fun.

* * *

>time
Your pocketwatch reads 10:15 am.

* * *

>x paper
The paper contains scribblings from the Little Snoreing train station, about twenty miles down the trail.  The train only comes through town once per day, and by your partner's calculations, it should speeding through this mountain around 10:30am.  Angry smeared handwriting screams "MOUNTAIN, DYNAMIC MIGHT ETHZF... TRAIN TUNNEL ^$*@ DON'T BELLATE."