BAM!  A mug of ale hits the table, splashing your shoes.  Muddy Charlie slumps back in his chair, eyes you carefully, and starts to chuckle.

"You know your problem?  You don't think big enough."

His expression is familiar.  Last time you saw that look, it was just before you two decided to hijack the mayor's private herd back in 1866.  That didn't work so well.

"What now?" you ask.  "A new idea?"

"Big plans."  He grins widely.  "That new cross-country railroad is almost finished.  It's gonna change everything... bigger trains, more people... and prize-winning cargo."

"A train holdup?  Are you kidding?"

"Relax.  This time we got technology on our side."  He leans close and whispers:  "Made in Sweden... or Germany.  It's big, dangerous, and nobody knows about it yet."

"A new weapon?"

"Dynamic, buddy.  Dynamic Might." 

Trainstopping
An IntroComp 2007 game entry by Ben Collins-Sussman
Release 1 / Serial number 070801 / Inform 7 build 4U67 (I6/v6.31 lib 6/11N) SD

Dirt Road
Muddy wasn't particularly clear in his instructions, but you're pretty sure this is the trail he wanted you to follow this morning.  Now that your horse has inexplicably bolted, you can use all the luck you can get.

This is a dusty trail that wanders off east and west for miles.  The sun blasts down on the back of your neck, but you can smell the cool tang of some pine trees off to the north.  You also spy the lower slopes of a small mountain that way.

>n
You shamble slowly toward the trees.

Copse
Lots of trees.

* * *

>up
Grassy Plateau
Ooh, it's grassy here.

You can see a chipmunk here.

>ne
Bluff
You're standing on a wide bluff about fifty feet up a small mountain, overlooking a landscape of sun-blasted plains and craggy hills.  Below you, a train track runs out of a narrow tunnel though the hill.  On the far edge of the bluff you see a strange rock formation, and a path wanders southwest through the brush.

You can see a stick bundle here.

>x rocks
The rocks are a few feet high, and are roughly arranged in a circle, almost like an oversized fire-pit.  It's not clear if they fell into this formation, or were pushed.

>enter rocks
You get into the circle of rocks.

>shoot bundle
BANG!  You shoot the stick bundle with the pistol. 
A fiery flash and earth-shattering boom rocks you!  The shock wave literally knocks you off your feet, as debris explodes in all directions.

>exit
You get out of the circle of rocks.

Bluff
You're standing on a wide bluff about fifty feet up a small mountain, overlooking a landscape of sun-blasted plains and craggy hills.  Below you, a train track runs out of a narrow tunnel though the hill.  On the far edge of the bluff you see a strange rock formation, and a path wanders southwest through the brush.

>restart
Are you sure you want to restart?

* * *

>ne
Bluff
You're standing on a wide bluff about fifty feet up a small mountain, overlooking a landscape of sun-blasted plains and craggy hills.  Below you, a train track runs out of a narrow tunnel though the hill.  On the far edge of the bluff you see a strange rock formation, and a path wanders southwest through the brush.

You can see a stick bundle here.

>shoot bundle
BANG!  You shoot the stick bundle with the pistol. 
A fiery flash and earth-shattering boom rocks you!  The shock wave literally knocks you off your feet, as debris explodes in all directions.

* * *

>l
Bluff (in the circle of rocks)
You're standing on a wide bluff about fifty feet up a small mountain, overlooking a landscape of sun-blasted plains and craggy hills.  Below you, a train track runs out of a narrow tunnel though the hill.  On the far edge of the bluff you see a strange rock formation, and a path wanders southwest through the brush.

You can see a stick bundle here.

>shoot bundle
BANG!  You shoot the stick bundle with the pistol. 
A fiery flash and earth-shattering boom rocks you!  The shock wave literally knocks you off your feet, as debris explodes in all directions.

* * *

>ne
Bluff
You're standing on a wide bluff about fifty feet up a small mountain, overlooking a landscape of sun-blasted plains and craggy hills.  Below you, a train track runs out of a narrow tunnel though the hill.  On the far edge of the bluff you see a strange rock formation, and a path wanders southwest through the brush.

You can see a stick bundle here.

>open rocks
That's not something you can open.

>close rocks
That's not something you can close.

* * *

>ne
Bluff
You're standing on a wide bluff about fifty feet up a small mountain, overlooking a landscape of sun-blasted plains and craggy hills.  Below you, a train track runs out of a narrow tunnel though the hill.  On the far edge of the bluff you see a strange rock formation, and a path wanders southwest through the brush.

You can see a stick bundle here.

>enter rocks
You get into the circle of rocks.

>show
What do you want to show yourself?

>showme
Bluff - room
    Track - backdrop
    stick bundle
    circle of rocks - transparent open container
        yourself - player-character
            hat (worn) - open container
            pocketwatch
            scrap of paper
            pistol - gun

>exit rocks
I only understood you as far as wanting to exit.

>exit circle
I only understood you as far as wanting to exit.

>sw
You'll have to get out of the circle of rocks first.

>get out of rocks
I only understood you as far as wanting to get the outside.

>shoot bundle
BANG!  You shoot the stick bundle with the pistol. 
A fiery flash and earth-shattering boom rocks you!  The shock wave literally knocks you off your feet, as debris explodes in all directions.

>sw
You'll have to get out of the circle of rocks first.

>stand up
You get out of the circle of rocks.

Bluff
You're standing on a wide bluff about fifty feet up a small mountain, overlooking a landscape of sun-blasted plains and craggy hills.  Below you, a train track runs out of a narrow tunnel though the hill.  On the far edge of the bluff you see a strange rock formation, and a path wanders southwest through the brush.

You can see a circle of rocks (empty) here.

>enter circle
You get into the circle of rocks.

>get out
You get out of the circle of rocks.

Bluff
You're standing on a wide bluff about fifty feet up a small mountain, overlooking a landscape of sun-blasted plains and craggy hills.  Below you, a train track runs out of a narrow tunnel though the hill.  On the far edge of the bluff you see a strange rock formation, and a path wanders southwest through the brush.

You can see a circle of rocks (empty) here.

High above, a vulture glides into the area.

>enter circle
You get into the circle of rocks.

The vulture sails off, heading southwest.

>l
Bluff (in the circle of rocks)
You're standing on a wide bluff about fifty feet up a small mountain, overlooking a landscape of sun-blasted plains and craggy hills.  Below you, a train track runs out of a narrow tunnel though the hill.  On the far edge of the bluff you see a strange rock formation, and a path wanders southwest through the brush.

>sw
You'll have to get out of the circle of rocks first.

A train whistles in the distance, bellowing steam!

>get out
You get out of the circle of rocks.

Bluff
You're standing on a wide bluff about fifty feet up a small mountain, overlooking a landscape of sun-blasted plains and craggy hills.  Below you, a train track runs out of a narrow tunnel though the hill.  On the far edge of the bluff you see a strange rock formation, and a path wanders southwest through the brush.

You can see a circle of rocks (empty) here.

>x train
It's a hulking, steam-driven locomotive, pulling at least ten cars behind it.   You can see it chugging along, getting closer by the second.

The train is moving down the track, getting closer.

* * *

>enter rocks
You get into the circle of rocks.

>exit
You get out of the circle of rocks.

Bluff
You're standing on a wide bluff about fifty feet up a small mountain, overlooking a landscape of sun-blasted plains and craggy hills.  Below you, a train track runs out of a narrow tunnel though the hill.  On the far edge of the bluff you see a strange rock formation, and a path wanders southwest through the brush.

You can see a stick bundle here.

>shoot bundle
BANG!  You shoot the stick bundle with the pistol. 
A fiery flash and earth-shattering boom rocks you!  The shock wave literally knocks you off your feet, as debris explodes in all directions.
Unfortunately, being unprotected, you were engulfed in the flames.

    *** Ouch. ***

In that game you scored 0 out of a possible 0, in 6 turns.

Would you like to RESTART, RESTORE a saved game, or QUIT?

* * *

>shoot bundle
BANG!  You shoot the stick bundle with the pistol. 
A fiery flash and earth-shattering boom rocks you!  The shock wave literally knocks you off your feet, as debris explodes in all directions.

>shoot self
BANG!  You shoot yourself with the pistol.   Murder can be... fun.

* * *

>up
Grassy Plateau
Ooh, it's grassy here.

You can see a chipmunk here.

>x chipmunk
A slippery little varmint.  He appears to be searching for something.

High above, a vulture glides into the area.

>ne
Bluff
You're standing on a wide bluff about fifty feet up a small mountain, overlooking a landscape of sun-blasted plains and craggy hills.  Below you, a train track runs out of a narrow tunnel though the hill.  On the far edge of the bluff you see a strange rock formation, and a path wanders southwest through the brush.

You can see a stick bundle and a circle of rocks (empty) here.

>x rocks
The rocks are a few feet high, and are roughly arranged in a circle, almost like an oversized fire-pit.  It's not clear if they fell into this formation, or were pushed.

>enter circle
That's not something you can enter.

* * *

>n
You shamble slowly toward the trees.

Copse
Lots of trees.

>shoot self
BANG!  You shoot yourself with the pistol.   Murder can be... fun.

* * *

>n
You shamble slowly toward the trees.

Copse
Lots of trees.

>z
Time passes.

* * *

>n
You shamble slowly toward the trees.

Copse
Lots of trees.

>n
You shamble slowly toward the trees.

You can't go that way.

>i
You are carrying:
  a hat (being worn)
  a pocketwatch
  a scrap of paper
  your trusty pistol

>l
Bluff
You're standing on a wide bluff about fifty feet up a small mountain, overlooking a landscape of sun-blasted plains and craggy hills.  Below you, a train track runs out of a narrow tunnel though the hill.  On the far edge of the bluff you see a strange rock formation, and a path wanders southwest through the brush.

You can see a stick bundle and a circle of rocks (in which is If the player) here.

* * *

>z
Time passes.

* * *

>shoot self
BANG!  You shoot yourself with the pistol.   Murder can be... fun.

* * *

>shoot hat
BANG!  You shoot the hat with the pistol.

* * *

>time
Your pocketwatch reads 10:15 am.